"","ESTABLISHMENT_ID","IsED","Inspection","Minor","Significant","Crucial","Total"
"1","10185207",0,4,0,0,0,0
"2","10185216",0,6,2,1,1,4
"3","10185464",0,1,1,0,0,1
"4","10185511",0,6,3,3,0,6
"5","10185533",0,4,0,0,0,0
"6","10185562",0,9,10,15,1,26
"7","10185572",0,3,4,2,0,6
"8","10185696",0,4,4,0,0,4
"9","10186202",0,5,1,0,0,1
"10","10186209",0,3,0,0,0,0
"11","10186218",0,2,0,0,0,0
"12","10186365",0,1,0,0,0,0
"13","10186467",0,1,0,0,0,0
"14","10186502",0,3,0,0,0,0
"15","10186546",0,5,5,3,1,9
"16","10186651",0,1,0,1,0,1
"17","10186689",0,7,1,3,0,4
"18","10186695",0,3,1,1,1,3
"19","10186737",0,1,0,0,0,0
"20","10186738",0,4,3,3,0,6
"21","10186811",0,3,2,6,0,8
"22","10186867",0,4,0,0,0,0
"23","10186892",0,3,0,0,0,0
"24","10187087",0,4,1,1,0,2
"25","10187303",0,8,2,2,1,5
"26","10187408",0,2,0,1,0,1
"27","10187419",0,1,0,0,0,0
"28","10187444",0,4,0,0,0,0
"29","10187448",0,3,1,1,1,3
"30","10187502",0,1,0,0,0,0
"31","10187555",0,2,0,0,0,0
"32","10187658",0,5,0,0,0,0
"33","10187687",0,3,1,0,0,1
"34","10187696",0,1,0,0,0,0
"35","10187739",0,1,0,0,0,0
"36","10187740",0,1,0,0,0,0
"37","10187754",0,7,6,2,1,9
"38","10187860",0,5,0,0,0,0
"39","10187946",0,5,7,7,0,14
"40","10187987",0,3,7,1,0,8
"41","10188034",0,1,0,0,0,0
"42","10188062",0,4,1,1,0,2
"43","10188112",0,2,0,0,0,0
"44","10188157",0,8,2,0,0,2
"45","10188196",0,4,4,1,0,5
"46","10188233",0,6,0,0,0,0
"47","10188398",0,4,0,1,0,1
"48","10188415",0,4,0,0,0,0
"49","10188474",0,4,0,0,0,0
"50","10188481",0,4,5,3,1,9
"51","10188739",0,6,3,0,0,3
"52","10188945",0,3,3,0,0,3
"53","10188976",0,3,1,3,2,6
"54","10189021",0,2,0,0,0,0
"55","10189064",0,1,0,0,0,0
"56","10189075",0,4,0,1,0,1
"57","10189077",0,4,0,1,0,1
"58","10189129",0,4,3,0,0,3
"59","10189141",0,2,0,0,0,0
"60","10189144",0,4,5,0,0,5
"61","10189204",0,6,0,0,0,0
"62","10189358",0,3,0,0,0,0
"63","10189369",0,6,8,16,3,27
"64","10189395",0,3,0,0,0,0
"65","10189403",0,2,1,1,0,2
"66","10189406",0,3,0,0,0,0
"67","10189677",0,2,0,0,0,0
"68","10189697",0,6,4,3,0,7
"69","10189706",0,3,0,0,0,0
"70","10189830",0,6,3,0,0,3
"71","10189834",0,4,2,0,0,2
"72","10189919",0,5,5,3,0,8
"73","10190054",0,5,10,3,1,14
"74","10190076",0,4,0,0,0,0
"75","10190082",0,2,1,0,0,1
"76","10190118",0,6,7,2,0,9
"77","10190119",0,1,0,0,0,0
"78","10190126",0,2,0,0,0,0
"79","10190139",0,5,3,5,0,8
"80","10190156",0,6,5,1,0,6
"81","10190260",0,4,0,0,0,0
"82","10190274",0,3,3,0,0,3
"83","10190346",0,5,1,5,0,6
"84","10190483",0,4,1,0,0,1
"85","10190577",0,3,1,0,0,1
"86","10190601",0,2,2,2,0,4
"87","10190625",0,3,0,0,0,0
"88","10190737",0,3,0,0,0,0
"89","10190751",0,4,0,0,0,0
"90","10190775",0,2,0,0,0,0
"91","10190827",0,4,1,1,0,2
"92","10190876",0,2,0,1,0,1
"93","10190956",0,4,0,0,0,0
"94","10191241",0,4,0,0,0,0
"95","10191243",0,4,1,1,0,2
"96","10191335",0,5,2,1,0,3
"97","10191362",0,4,2,1,0,3
"98","10191372",0,9,10,6,1,17
"99","10191496",0,4,4,1,0,5
"100","10191594",0,6,1,0,0,1
"101","10191748",0,7,16,2,0,18
"102","10191813",0,3,1,3,0,4
"103","10191833",0,8,21,26,6,53
"104","10191924",0,10,9,7,2,18
"105","10191928",0,4,0,3,0,3
"106","10192004",1,4,3,0,0,3
"107","10192032",0,2,2,0,0,2
"108","10192053",0,1,0,0,0,0
"109","10192185",0,3,0,0,0,0
"110","10192200",0,4,1,0,0,1
"111","10192229",0,4,0,0,0,0
"112","10192244",0,1,0,0,0,0
"113","10192250",0,7,5,14,2,21
"114","10192258",0,5,1,0,0,1
"115","10192263",0,5,1,0,0,1
"116","10192302",0,6,0,0,0,0
"117","10192475",0,1,0,0,0,0
"118","10192486",0,3,1,0,0,1
"119","10192599",0,4,10,4,0,14
"120","10192638",0,3,1,1,0,2
"121","10192639",0,5,7,1,2,10
"122","10192723",0,2,1,0,0,1
"123","10192856",0,1,0,0,0,0
"124","10192883",0,5,5,1,0,6
"125","10192936",0,1,0,0,0,0
"126","10193153",0,5,4,1,0,5
"127","10193279",0,1,0,0,0,0
"128","10193570",0,1,0,0,0,0
"129","10193576",0,3,3,2,0,5
"130","10193647",0,3,1,0,0,1
"131","10193663",0,4,2,2,0,4
"132","10193708",0,2,0,0,0,0
"133","10193778",0,2,0,0,0,0
"134","10193782",0,6,3,0,0,3
"135","10193788",0,3,1,0,0,1
"136","10193869",0,4,1,0,0,1
"137","10193878",0,1,2,0,0,2
"138","10193989",0,3,3,1,0,4
"139","10194058",0,3,0,0,0,0
"140","10194075",0,4,3,0,0,3
"141","10194183",0,6,3,8,1,12
"142","10194565",0,1,0,0,0,0
"143","10194661",0,4,5,2,0,7
"144","10194806",0,2,0,2,0,2
"145","10194838",0,7,10,10,1,21
"146","10194895",0,3,3,3,0,6
"147","10194913",0,1,0,0,0,0
"148","10194934",0,2,1,1,0,2
"149","10194951",0,3,1,0,0,1
"150","10195080",0,6,3,2,0,5
"151","10195176",0,4,0,0,0,0
"152","10195291",0,3,0,3,0,3
"153","10195295",0,2,0,0,0,0
"154","10195379",0,7,9,8,2,19
"155","10195621",0,7,14,8,0,22
"156","10196103",0,5,2,1,0,3
"157","10196553",1,4,5,4,0,9
"158","10196816",0,2,0,0,0,0
"159","10196948",0,2,1,0,0,1
"160","10197086",0,4,0,0,0,0
"161","10197139",0,1,0,0,0,0
"162","10197432",0,6,5,5,0,10
"163","10197485",0,2,1,0,0,1
"164","10197515",0,5,2,5,0,7
"165","10197538",0,4,6,2,0,8
"166","10197554",0,4,3,0,0,3
"167","10197595",0,4,4,3,0,7
"168","10197785",0,4,1,2,0,3
"169","10197857",0,3,0,3,0,3
"170","10197889",0,1,2,2,0,4
"171","10197977",0,1,0,1,0,1
"172","10198116",0,3,1,0,0,1
"173","10198133",0,3,0,0,0,0
"174","10198320",0,1,0,2,0,2
"175","10198346",0,4,0,0,0,0
"176","10198644",0,3,0,0,0,0
"177","10198651",0,3,3,2,0,5
"178","10198753",0,4,6,2,0,8
"179","10198926",0,3,0,0,0,0
"180","10198989",0,3,3,0,0,3
"181","10198992",0,5,0,0,0,0
"182","10199013",0,4,0,1,0,1
"183","10199075",0,1,0,0,0,0
"184","10199087",0,3,0,0,0,0
"185","10199335",0,4,0,0,0,0
"186","10199369",0,4,1,0,0,1
"187","10199450",0,5,6,13,0,19
"188","10199468",0,4,3,0,0,3
"189","10199628",0,6,6,3,0,9
"190","10199658",0,4,3,1,0,4
"191","10199780",0,4,5,2,0,7
"192","10199804",0,3,1,0,0,1
"193","10199858",0,5,6,4,0,10
"194","10200113",0,1,0,0,0,0
"195","10200138",0,10,19,8,2,29
"196","10200157",0,1,0,0,0,0
"197","10200390",0,2,0,0,0,0
"198","10200453",0,4,1,1,0,2
"199","10200465",0,2,0,0,0,0
"200","10200570",0,6,0,2,0,2
"201","10200627",0,4,5,5,0,10
"202","10200814",0,3,2,0,0,2
"203","10200987",0,4,0,0,0,0
"204","10201118",0,5,0,2,0,2
"205","10201146",0,6,3,1,3,7
"206","10201164",0,4,0,0,0,0
"207","10201197",0,1,1,0,0,1
"208","10201229",0,4,0,0,0,0
"209","10201272",0,3,0,0,0,0
"210","10201429",0,1,1,0,0,1
"211","10201470",0,4,0,0,0,0
"212","10201481",0,2,3,5,0,8
"213","10201525",0,3,0,0,0,0
"214","10201707",0,4,1,0,0,1
"215","10201722",0,1,0,0,0,0
"216","10201943",0,5,3,2,0,5
"217","10201963",0,5,4,1,0,5
"218","10202166",0,6,3,3,0,6
"219","10202321",0,4,4,0,0,4
"220","10202519",0,1,0,0,0,0
"221","10202709",0,6,4,1,1,6
"222","10202730",0,1,0,0,0,0
"223","10202748",0,4,6,2,0,8
"224","10202834",0,4,0,2,0,2
"225","10202851",0,5,1,0,0,1
"226","10203136",0,5,3,0,0,3
"227","10203312",0,4,2,2,0,4
"228","10203480",0,2,0,0,0,0
"229","10203580",0,1,0,0,0,0
"230","10203813",0,5,3,0,0,3
"231","10203876",0,3,6,5,0,11
"232","10204321",0,7,1,3,0,4
"233","10204662",0,7,16,4,0,20
"234","10204686",0,1,0,1,0,1
"235","10204974",0,5,9,9,2,20
"236","10205302",0,4,0,0,0,0
"237","10205315",0,1,0,0,0,0
"238","10205381",0,2,0,0,0,0
"239","10205427",0,1,0,0,0,0
"240","10205494",0,4,0,0,0,0
"241","10205558",0,4,0,0,0,0
"242","10205581",0,3,2,0,0,2
"243","10205717",0,2,0,0,0,0
"244","10205719",0,3,1,2,0,3
"245","10205952",0,4,4,0,0,4
"246","10206294",0,4,2,1,0,3
"247","10206386",0,2,3,0,0,3
"248","10206419",0,4,4,3,0,7
"249","10206620",0,2,1,2,0,3
"250","10206653",0,4,0,1,0,1
"251","10206784",0,1,0,0,0,0
"252","10206825",0,7,10,5,1,16
"253","10206938",0,4,1,4,0,5
"254","10207015",0,3,0,0,0,0
"255","10207020",0,7,11,9,2,22
"256","10207031",0,3,0,0,0,0
"257","10207076",0,5,0,0,0,0
"258","10207093",0,9,16,17,0,33
"259","10207132",0,3,4,1,0,5
"260","10207140",0,2,1,0,0,1
"261","10207323",0,4,2,4,0,6
"262","10207491",0,4,3,3,0,6
"263","10207546",0,4,2,1,0,3
"264","10207593",0,5,2,0,0,2
"265","10207655",0,2,3,0,0,3
"266","10207714",0,2,1,1,0,2
"267","10207745",0,3,1,1,0,2
"268","10207773",0,4,1,0,0,1
"269","10207814",0,3,0,0,0,0
"270","10207969",0,4,0,0,0,0
"271","10207999",0,6,7,3,1,11
"272","10208063",0,7,8,9,1,18
"273","10208094",0,4,0,1,0,1
"274","10208225",0,4,0,0,0,0
"275","10208368",0,6,14,1,1,16
"276","10208537",0,3,0,0,0,0
"277","10208599",0,4,1,0,0,1
"278","10208806",0,4,0,0,0,0
"279","10208916",0,4,0,0,0,0
"280","10208951",0,3,0,0,0,0
"281","10208976",0,2,0,0,0,0
"282","10209046",0,3,0,0,0,0
"283","10209134",0,8,19,14,2,35
"284","10209161",0,5,2,0,0,2
"285","10209243",0,1,0,0,0,0
"286","10209257",0,2,0,0,0,0
"287","10209320",0,6,4,3,0,7
"288","10209392",0,4,1,0,0,1
"289","10209424",0,1,0,1,0,1
"290","10209440",0,4,5,1,0,6
"291","10209496",0,5,2,1,0,3
"292","10209498",0,4,2,1,0,3
"293","10209733",0,5,2,0,0,2
"294","10209743",0,2,0,1,0,1
"295","10210939",1,4,0,0,0,0
"296","10211247",0,4,1,0,0,1
"297","10211314",0,5,4,1,0,5
"298","10211387",0,3,2,0,0,2
"299","10211457",0,5,4,2,0,6
"300","10211463",0,4,1,1,0,2
"301","10211509",0,3,1,1,0,2
"302","10211713",0,6,6,2,1,9
"303","10211754",0,4,6,2,0,8
"304","10211882",0,1,0,0,0,0
"305","10212091",0,2,0,1,0,1
"306","10212104",0,3,1,1,0,2
"307","10212159",0,3,0,2,0,2
"308","10212227",0,1,0,1,0,1
"309","10212263",0,5,5,0,0,5
"310","10212343",0,2,0,0,0,0
"311","10212368",0,5,0,0,0,0
"312","10212382",0,6,8,2,0,10
"313","10212499",0,5,4,4,0,8
"314","10212558",0,4,6,3,0,9
"315","10212709",0,2,0,0,0,0
"316","10212722",0,2,0,0,0,0
"317","10212741",0,3,0,0,0,0
"318","10212768",0,4,2,0,0,2
"319","10212926",0,4,3,0,0,3
"320","10212935",0,5,1,1,0,2
"321","10212962",0,11,8,16,2,26
"322","10212976",0,7,5,8,2,15
"323","10212998",0,2,0,0,0,0
"324","10213033",0,1,2,0,0,2
"325","10213099",0,3,0,0,0,0
"326","10213168",0,1,0,0,0,0
"327","10213308",0,2,2,0,0,2
"328","10213322",0,2,0,1,0,1
"329","10213357",0,5,3,2,1,6
"330","10213376",0,1,0,0,0,0
"331","10213405",0,5,7,4,0,11
"332","10213507",0,4,1,0,0,1
"333","10213686",0,2,0,0,0,0
"334","10213755",0,9,13,17,2,32
"335","10213807",1,5,1,0,0,1
"336","10213829",0,5,0,0,0,0
"337","10213985",0,8,16,12,0,28
"338","10214008",0,2,0,0,0,0
"339","10214011",0,3,3,0,0,3
"340","10214041",0,1,0,0,0,0
"341","10214143",0,4,4,0,0,4
"342","10214206",0,4,0,0,0,0
"343","10214364",1,10,11,4,0,15
"344","10214410",0,4,7,4,1,12
"345","10214422",0,1,0,0,0,0
"346","10214513",0,3,1,0,0,1
"347","10214579",0,4,3,1,0,4
"348","10214812",0,2,0,0,0,0
"349","10214840",0,8,16,11,1,28
"350","10214857",0,3,2,2,0,4
"351","10214960",0,2,2,0,0,2
"352","10215067",0,1,0,0,0,0
"353","10215250",0,5,5,0,0,5
"354","10215351",0,3,2,1,0,3
"355","10215392",0,3,3,3,0,6
"356","10215467",0,7,1,0,0,1
"357","10215499",0,7,9,4,1,14
"358","10215547",0,1,0,0,0,0
"359","10215626",0,4,0,0,0,0
"360","10215634",0,4,0,0,0,0
"361","10215659",0,3,5,0,0,5
"362","10215665",0,2,0,0,0,0
"363","10215681",0,1,0,0,0,0
"364","10215690",0,6,0,1,0,1
"365","10215693",0,3,3,8,0,11
"366","10215712",0,3,2,0,0,2
"367","10215781",0,6,1,2,0,3
"368","10215785",0,6,2,1,0,3
"369","10215799",0,6,0,0,0,0
"370","10215829",0,4,4,2,0,6
"371","10215880",0,5,0,0,0,0
"372","10215912",0,4,0,1,0,1
"373","10215916",0,4,2,0,0,2
"374","10215949",0,2,0,0,0,0
"375","10216239",0,4,3,0,0,3
"376","10216240",0,2,0,0,0,0
"377","10216355",0,2,0,0,0,0
"378","10216420",0,1,0,0,0,0
"379","10216422",0,2,0,0,0,0
"380","10216424",0,2,0,0,0,0
"381","10216452",0,3,0,0,0,0
"382","10216497",0,3,5,0,0,5
"383","10216636",1,3,0,0,0,0
"384","10216660",0,5,5,8,1,14
"385","10216738",0,7,15,3,0,18
"386","10216758",0,1,0,0,0,0
"387","10216772",0,1,0,0,0,0
"388","10216936",0,4,0,1,0,1
"389","10216943",0,6,3,1,0,4
"390","10216979",0,4,2,0,0,2
"391","10217036",0,5,0,0,0,0
"392","10217062",0,4,1,0,0,1
"393","10217432",0,6,7,1,0,8
"394","10217504",0,4,0,0,0,0
"395","10217505",0,4,0,0,0,0
"396","10217513",0,3,2,4,0,6
"397","10217563",0,2,0,0,0,0
"398","10217849",0,5,8,7,0,15
"399","10217926",0,3,1,0,0,1
"400","10217951",0,7,8,1,0,9
"401","10218156",0,6,1,0,0,1
"402","10218650",0,4,1,0,0,1
"403","10218746",0,1,0,0,0,0
"404","10218788",0,1,0,0,0,0
"405","10218891",1,5,0,1,0,1
"406","10218906",0,7,0,4,2,6
"407","10218912",0,1,0,0,0,0
"408","10218984",0,3,0,0,0,0
"409","10218993",0,1,0,0,0,0
"410","10218994",0,1,2,0,0,2
"411","10218995",0,2,0,0,0,0
"412","10218996",0,2,0,1,0,1
"413","10219267",0,7,2,5,0,7
"414","10219301",0,4,0,0,0,0
"415","10219571",0,6,6,2,2,10
"416","10219713",0,1,0,0,0,0
"417","10219731",0,4,2,2,0,4
"418","10219742",0,1,0,0,0,0
"419","10219759",0,2,0,0,0,0
"420","10219778",0,6,4,4,2,10
"421","10219788",0,2,0,1,0,1
"422","10219837",0,1,0,0,0,0
"423","10219882",0,4,1,1,0,2
"424","10219974",0,4,2,0,0,2
"425","10220292",0,4,11,3,0,14
"426","10220331",0,4,1,1,0,2
"427","10220411",0,4,0,0,0,0
"428","10220437",0,2,2,1,0,3
"429","10220451",0,3,0,0,0,0
"430","10220458",0,4,1,0,0,1
"431","10220462",0,4,0,0,0,0
"432","10220468",0,4,0,0,0,0
"433","10220481",0,3,0,0,0,0
"434","10220526",0,4,2,0,0,2
"435","10220528",0,4,0,0,0,0
"436","10220738",0,2,3,0,0,3
"437","10220785",0,3,0,0,0,0
"438","10220907",0,2,1,1,0,2
"439","10220923",0,4,0,0,0,0
"440","10221024",0,6,8,3,0,11
"441","10221035",0,4,0,0,0,0
"442","10221093",0,1,0,0,0,0
"443","10221127",0,4,0,0,0,0
"444","10221144",0,3,4,0,0,4
"445","10221157",0,3,1,0,0,1
"446","10221161",0,3,0,0,0,0
"447","10221251",0,1,0,0,0,0
"448","10221395",0,3,1,1,0,2
"449","10221407",0,4,0,0,0,0
"450","10221802",0,2,0,0,0,0
"451","10221821",0,7,7,3,1,11
"452","10221827",0,6,3,3,0,6
"453","10221874",0,1,0,0,0,0
"454","10221912",0,2,0,0,0,0
"455","10222129",0,2,0,0,0,0
"456","10222135",0,1,1,0,0,1
"457","10222138",0,3,0,0,0,0
"458","10222170",0,2,4,0,0,4
"459","10222208",0,6,9,1,0,10
"460","10222229",0,5,3,1,0,4
"461","10222372",0,6,5,4,0,9
"462","10222470",0,1,0,0,0,0
"463","10222572",0,5,4,5,1,10
"464","10222574",0,4,4,1,0,5
"465","10222575",0,7,12,4,0,16
"466","10222641",0,4,7,1,0,8
"467","10222653",0,6,10,7,1,18
"468","10222711",0,6,12,3,0,15
"469","10222731",0,6,0,1,0,1
"470","10222750",0,3,1,0,0,1
"471","10222751",0,2,1,1,0,2
"472","10222820",0,2,1,1,0,2
"473","10222894",0,7,8,1,0,9
"474","10223015",0,5,0,4,0,4
"475","10223090",0,4,3,0,0,3
"476","10223119",0,5,6,6,1,13
"477","10223167",0,5,6,3,0,9
"478","10223213",0,8,6,2,0,8
"479","10223230",0,3,1,0,0,1
"480","10223243",0,5,1,2,0,3
"481","10223264",0,6,6,4,2,12
"482","10223362",0,6,8,2,0,10
"483","10223370",0,3,1,1,0,2
"484","10223402",0,2,0,0,0,0
"485","10223423",0,1,0,0,0,0
"486","10223590",0,2,2,0,0,2
"487","10223653",0,4,0,1,1,2
"488","10223665",1,2,0,0,0,0
"489","10223678",0,2,0,0,0,0
"490","10223839",0,5,1,0,0,1
"491","10223866",0,4,4,2,0,6
"492","10223895",0,4,1,0,0,1
"493","10223926",0,2,0,0,0,0
"494","10223954",0,6,5,5,1,11
"495","10223998",0,1,0,0,0,0
"496","10224018",0,1,0,0,0,0
"497","10224065",0,1,0,0,0,0
"498","10224073",0,3,3,0,0,3
"499","10224205",0,3,0,1,0,1
"500","10224212",0,5,11,3,0,14
"501","10224222",0,5,6,9,1,16
"502","10224226",0,1,3,1,0,4
"503","10224258",0,4,4,3,1,8
"504","10224359",0,3,4,2,0,6
"505","10224534",0,1,0,0,0,0
"506","10224560",0,3,0,0,0,0
"507","10224568",0,1,0,0,0,0
"508","10224679",0,5,5,6,0,11
"509","10224691",0,3,0,0,0,0
"510","10224752",0,5,2,1,0,3
"511","10224836",0,2,0,0,0,0
"512","10224872",0,1,2,0,0,2
"513","10225093",0,2,0,0,0,0
"514","10225095",0,2,0,0,0,0
"515","10225109",0,4,3,3,0,6
"516","10225168",0,4,5,0,0,5
"517","10225546",0,4,3,1,0,4
"518","10225617",0,2,0,0,0,0
"519","10225707",0,3,1,0,0,1
"520","10225725",0,5,1,1,0,2
"521","10225856",0,6,6,7,0,13
"522","10225915",0,1,1,1,0,2
"523","10226024",0,2,0,0,0,0
"524","10226138",1,5,1,3,0,4
"525","10226190",0,2,0,1,0,1
"526","10226270",0,1,0,0,0,0
"527","10226288",0,3,2,1,0,3
"528","10226466",0,5,7,1,0,8
"529","10226468",0,5,13,0,0,13
"530","10226530",0,3,1,0,0,1
"531","10226863",0,2,0,0,0,0
"532","10227082",0,6,2,0,0,2
"533","10227087",0,4,0,0,0,0
"534","10227695",0,3,3,1,0,4
"535","10227743",0,4,1,0,0,1
"536","10227837",0,2,1,1,0,2
"537","10228019",0,1,0,1,0,1
"538","10228057",0,6,8,1,0,9
"539","10228103",0,6,0,0,0,0
"540","10228308",0,5,0,0,0,0
"541","10228312",0,4,0,0,0,0
"542","10228322",0,4,0,0,0,0
"543","10228351",0,1,0,0,0,0
"544","10228424",0,1,0,0,0,0
"545","10228520",0,4,1,0,0,1
"546","10228529",0,5,3,0,0,3
"547","10228566",0,6,0,0,0,0
"548","10228610",0,4,0,0,0,0
"549","10228616",0,3,0,0,0,0
"550","10228697",0,3,6,1,0,7
"551","10228718",0,1,0,0,0,0
"552","10228779",0,3,1,0,0,1
"553","10229005",0,1,0,0,0,0
"554","10229072",0,2,0,0,0,0
"555","10229088",0,4,3,2,0,5
"556","10229115",0,5,0,0,0,0
"557","10229125",0,3,0,0,0,0
"558","10229342",0,4,8,3,0,11
"559","10229359",0,2,1,0,0,1
"560","10229366",0,8,8,7,0,15
"561","10229524",0,2,0,0,0,0
"562","10229556",0,5,1,0,0,1
"563","10229586",0,4,0,0,0,0
"564","10229795",0,2,0,3,0,3
"565","10229802",0,4,0,0,0,0
"566","10229814",0,5,3,1,0,4
"567","10229880",0,6,8,4,0,12
"568","10229964",0,5,5,0,0,5
"569","10230100",0,4,9,0,0,9
"570","10230146",0,2,2,3,0,5
"571","10230181",0,5,5,6,2,13
"572","10230246",0,2,0,0,0,0
"573","10230265",0,4,0,1,0,1
"574","10230273",0,2,0,0,0,0
"575","10230318",0,3,0,0,0,0
"576","10230375",0,5,0,2,1,3
"577","10230387",0,5,2,1,0,3
"578","10230432",0,3,1,1,0,2
"579","10230437",0,7,10,7,0,17
"580","10230451",0,5,0,0,0,0
"581","10230603",0,4,0,0,0,0
"582","10230608",0,6,2,0,0,2
"583","10230727",0,3,4,0,0,4
"584","10230818",0,1,0,0,0,0
"585","10230836",0,4,2,0,0,2
"586","10230934",0,4,3,1,0,4
"587","10230985",0,6,8,1,1,10
"588","10231048",0,3,5,1,0,6
"589","10231396",0,4,9,6,0,15
"590","10231398",0,3,2,0,0,2
"591","10231464",0,4,2,0,0,2
"592","10231630",0,9,8,6,3,17
"593","10231850",0,2,0,0,0,0
"594","10232005",0,3,0,2,0,2
"595","10232374",0,4,0,0,0,0
"596","10232442",0,1,0,0,0,0
"597","10232468",0,7,14,10,2,26
"598","10232742",0,8,6,3,0,9
"599","10232743",0,4,0,0,0,0
"600","10232745",0,3,0,0,0,0
"601","10232746",0,3,1,0,0,1
"602","10232749",0,4,0,0,0,0
"603","10232801",0,5,3,1,0,4
"604","10232806",0,4,0,0,0,0
"605","10232925",0,6,9,5,0,14
"606","10232999",0,3,3,2,0,5
"607","10233087",0,4,0,0,0,0
"608","10233122",0,6,6,8,2,16
"609","10233231",0,5,5,0,0,5
"610","10233242",0,4,0,1,0,1
"611","10233249",0,2,5,0,0,5
"612","10233253",0,4,5,0,0,5
"613","10233333",0,6,2,2,0,4
"614","10233727",0,5,1,1,0,2
"615","10233736",0,3,1,2,0,3
"616","10233752",0,1,0,0,0,0
"617","10233795",0,1,0,0,0,0
"618","10233921",0,2,1,0,0,1
"619","10233929",0,1,0,0,0,0
"620","10234239",0,4,1,0,0,1
"621","10234248",0,6,12,2,0,14
"622","10234391",0,5,5,2,0,7
"623","10234526",0,3,4,0,0,4
"624","10234625",0,1,0,0,0,0
"625","10234846",0,5,2,1,0,3
"626","10234911",0,4,3,2,0,5
"627","10234927",0,13,16,16,5,37
"628","10235027",0,4,7,1,0,8
"629","10235058",0,1,0,0,0,0
"630","10235081",0,1,0,0,0,0
"631","10235116",0,1,1,0,0,1
"632","10235144",0,5,4,1,0,5
"633","10235145",0,4,0,0,0,0
"634","10235147",0,1,0,0,0,0
"635","10235149",0,4,2,1,0,3
"636","10235216",0,1,0,0,0,0
"637","10235222",0,1,0,0,0,0
"638","10237250",0,1,0,1,0,1
"639","10237329",0,2,0,0,0,0
"640","10237380",0,5,4,3,0,7
"641","10237537",0,2,0,0,0,0
"642","10237603",0,1,1,1,0,2
"643","10237619",0,9,3,6,0,9
"644","10237690",0,4,1,0,0,1
"645","10237695",0,2,1,1,0,2
"646","10237729",0,5,6,1,1,8
"647","10238048",0,3,4,1,0,5
"648","10238050",0,2,0,0,0,0
"649","10238164",0,2,1,0,0,1
"650","10238366",0,6,11,3,0,14
"651","10238367",0,3,1,0,0,1
"652","10238394",0,7,6,1,1,8
"653","10238540",0,7,8,4,0,12
"654","10238551",0,1,2,0,0,2
"655","10238770",0,4,0,0,0,0
"656","10239031",0,3,0,0,0,0
"657","10239236",0,7,8,1,0,9
"658","10239415",0,4,0,0,0,0
"659","10239591",0,5,0,0,0,0
"660","10239689",0,2,0,0,0,0
"661","10240035",0,2,0,0,0,0
"662","10240178",0,1,0,0,0,0
"663","10240189",0,4,1,3,0,4
"664","10240382",0,8,10,5,1,16
"665","10240418",0,2,1,0,0,1
"666","10240508",0,4,2,1,0,3
"667","10240583",0,4,1,1,0,2
"668","10240752",0,2,0,0,0,0
"669","10241115",0,1,0,0,0,0
"670","10241147",0,4,1,1,0,2
"671","10241151",0,1,0,1,0,1
"672","10241498",0,3,1,0,0,1
"673","10241642",0,3,2,0,0,2
"674","10242059",0,3,1,0,0,1
"675","10242395",0,2,2,2,0,4
"676","10242672",0,3,9,2,0,11
"677","10243258",0,2,0,0,0,0
"678","10243591",0,8,13,5,0,18
"679","10244019",0,3,0,0,0,0
"680","10244072",0,1,0,0,0,0
"681","10244653",0,3,2,2,0,4
"682","10244661",0,6,4,2,1,7
"683","10245283",0,1,0,0,0,0
"684","10245430",0,4,0,0,0,0
"685","10245442",0,5,9,1,1,11
"686","10245519",0,7,6,6,1,13
"687","10245610",0,5,6,9,0,15
"688","10245776",0,5,11,0,0,11
"689","10245839",1,6,0,3,0,3
"690","10245844",0,3,5,2,0,7
"691","10245948",0,1,0,0,0,0
"692","10246078",0,1,0,1,0,1
"693","10246095",0,2,0,0,0,0
"694","10246274",0,5,3,4,0,7
"695","10246285",0,1,0,0,0,0
"696","10246288",0,2,0,0,0,0
"697","10246461",1,5,0,1,0,1
"698","10246470",1,12,19,12,7,38
"699","10246476",0,5,1,0,0,1
"700","10246519",0,5,1,0,0,1
"701","10247022",0,8,8,6,1,15
"702","10247212",0,4,0,0,0,0
"703","10247393",0,2,0,0,0,0
"704","10247422",0,4,4,0,0,4
"705","10247455",0,5,5,3,0,8
"706","10247459",0,5,2,3,0,5
"707","10247464",0,3,2,1,0,3
"708","10247479",0,4,4,2,0,6
"709","10247583",0,2,2,0,0,2
"710","10247630",0,1,0,0,0,0
"711","10247641",0,5,0,0,0,0
"712","10247839",0,4,0,0,0,0
"713","10247888",0,3,5,0,0,5
"714","10247898",0,1,0,3,0,3
"715","10247945",0,6,6,4,0,10
"716","10247993",0,3,0,0,0,0
"717","10247994",0,2,0,0,0,0
"718","10248191",0,2,0,0,0,0
"719","10248195",0,5,4,2,2,8
"720","10248328",0,4,3,3,0,6
"721","10248392",0,4,0,1,0,1
"722","10248415",0,3,0,2,0,2
"723","10248437",0,4,0,1,1,2
"724","10248464",0,1,1,0,0,1
"725","10248620",0,3,0,0,0,0
"726","10248700",0,1,0,0,0,0
"727","10248833",0,3,0,0,0,0
"728","10248891",0,2,0,0,0,0
"729","10248904",0,3,2,1,0,3
"730","10248977",0,5,6,2,0,8
"731","10249045",0,3,0,0,0,0
"732","10249082",0,6,0,0,0,0
"733","10249271",0,1,0,0,0,0
"734","10249412",0,3,1,0,0,1
"735","10249415",0,4,5,1,0,6
"736","10249440",0,4,7,2,0,9
"737","10249470",0,1,0,0,0,0
"738","10249606",0,1,0,0,0,0
"739","10249622",0,4,0,0,0,0
"740","10249631",0,3,0,0,0,0
"741","10249645",0,1,0,0,0,0
"742","10249781",0,3,0,0,0,0
"743","10249950",0,4,1,0,0,1
"744","10250148",0,8,3,2,1,6
"745","10250154",0,6,7,4,0,11
"746","10250210",1,4,2,4,0,6
"747","10250263",0,3,10,1,0,11
"748","10250429",0,5,3,4,0,7
"749","10250442",0,4,1,0,0,1
"750","10250493",0,3,0,1,0,1
"751","10250996",0,3,0,0,0,0
"752","10251032",0,1,0,0,0,0
"753","10251102",0,2,0,0,0,0
"754","10251115",0,5,2,2,0,4
"755","10251151",0,3,0,1,0,1
"756","10251171",0,2,1,0,0,1
"757","10251174",0,4,7,1,0,8
"758","10251187",0,1,0,0,0,0
"759","10251216",0,1,0,0,0,0
"760","10251247",0,1,0,0,0,0
"761","10251276",0,4,1,1,0,2
"762","10251358",0,6,0,0,0,0
"763","10251386",0,2,0,0,0,0
"764","10251470",0,4,4,1,0,5
"765","10251472",0,6,7,2,0,9
"766","10251486",0,3,0,0,0,0
"767","10251670",0,3,3,0,0,3
"768","10251728",0,1,0,0,0,0
"769","10251732",0,1,0,0,0,0
"770","10251751",0,5,6,3,0,9
"771","10252074",0,4,7,5,0,12
"772","10252174",0,4,0,0,0,0
"773","10252180",0,1,0,1,0,1
"774","10252292",0,7,6,3,0,9
"775","10252302",0,2,4,0,0,4
"776","10252328",0,4,2,0,0,2
"777","10252386",0,1,0,0,0,0
"778","10252471",0,3,3,1,0,4
"779","10252494",0,5,5,1,0,6
"780","10252681",0,2,1,0,0,1
"781","10252685",0,8,0,0,0,0
"782","10252727",0,1,0,0,0,0
"783","10252788",0,1,2,0,0,2
"784","10252888",0,1,0,0,0,0
"785","10252890",0,1,0,0,0,0
"786","10252894",0,3,4,2,0,6
"787","10252922",0,4,2,1,0,3
"788","10252949",0,1,1,1,0,2
"789","10253079",0,1,1,0,0,1
"790","10253124",0,4,0,0,0,0
"791","10253134",0,2,0,0,0,0
"792","10253137",0,4,0,1,0,1
"793","10253166",0,6,3,5,0,8
"794","10253177",0,5,5,2,0,7
"795","10253199",0,1,0,0,0,0
"796","10253245",0,4,1,0,0,1
"797","10253287",0,2,1,0,0,1
"798","10253390",0,3,1,0,0,1
"799","10253512",0,9,14,8,3,25
"800","10253520",0,1,0,0,0,0
"801","10253638",0,4,7,2,0,9
"802","10253721",0,4,0,1,0,1
"803","10253750",0,3,4,2,0,6
"804","10253793",0,3,1,3,1,5
"805","10253838",0,1,0,0,0,0
"806","10253883",0,1,0,0,0,0
"807","10253914",0,4,0,0,0,0
"808","10253963",0,1,0,0,0,0
"809","10254063",0,1,0,0,0,0
"810","10254093",0,5,4,8,0,12
"811","10254114",0,1,0,0,0,0
"812","10254119",0,1,0,0,0,0
"813","10254131",0,1,1,0,0,1
"814","10254243",0,3,6,0,0,6
"815","10254518",0,1,0,0,0,0
"816","10254638",0,5,1,3,1,5
"817","10254710",0,5,3,0,1,4
"818","10254750",0,3,1,1,0,2
"819","10254768",0,1,0,0,0,0
"820","10254873",0,2,0,0,0,0
"821","10254949",0,3,1,0,1,2
"822","10255014",0,5,11,3,0,14
"823","10255030",0,5,6,6,1,13
"824","10255031",0,4,0,0,0,0
"825","10255077",0,3,2,0,0,2
"826","10255203",0,1,1,0,0,1
"827","10255278",0,4,0,0,0,0
"828","10255320",0,5,0,0,0,0
"829","10255433",0,2,2,1,0,3
"830","10255486",0,4,1,1,0,2
"831","10255663",0,4,0,0,0,0
"832","10255980",0,5,5,0,1,6
"833","10256032",0,4,1,0,0,1
"834","10256081",0,8,7,3,1,11
"835","10256141",0,1,0,0,0,0
"836","10256286",0,1,1,0,0,1
"837","10256298",0,2,0,1,0,1
"838","10256354",0,4,0,2,0,2
"839","10256358",0,3,2,0,0,2
"840","10256435",0,5,6,2,0,8
"841","10256493",0,2,0,0,0,0
"842","10256520",0,3,4,0,0,4
"843","10256555",0,4,5,1,0,6
"844","10256712",0,4,8,0,0,8
"845","10256719",0,1,1,2,0,3
"846","10256730",0,6,2,1,0,3
"847","10256745",0,3,1,0,0,1
"848","10256931",0,4,5,0,0,5
"849","10256946",0,1,0,0,0,0
"850","10257034",1,3,1,0,0,1
"851","10257037",0,3,0,0,0,0
"852","10257067",0,2,1,0,0,1
"853","10257073",0,3,3,0,0,3
"854","10257336",0,4,0,0,0,0
"855","10257388",0,3,2,2,0,4
"856","10257419",0,4,5,4,0,9
"857","10257602",0,4,2,0,0,2
"858","10257632",0,2,0,0,0,0
"859","10257701",0,3,1,0,0,1
"860","10257782",0,2,1,0,0,1
"861","10257814",0,2,0,0,0,0
"862","10257990",1,2,0,0,0,0
"863","10257991",0,6,6,10,1,17
"864","10258115",0,6,0,0,0,0
"865","10258214",0,4,0,0,0,0
"866","10258313",0,1,0,0,0,0
"867","10258322",0,1,0,0,0,0
"868","10258327",0,4,3,1,0,4
"869","10258433",0,4,0,0,0,0
"870","10258618",0,7,13,6,0,19
"871","10258621",0,4,3,2,0,5
"872","10258794",0,3,3,3,0,6
"873","10258911",0,6,2,4,0,6
"874","10259129",0,3,3,0,0,3
"875","10259223",0,2,0,0,0,0
"876","10259543",0,4,1,0,0,1
"877","10259545",0,1,0,0,0,0
"878","10259565",0,8,2,5,0,7
"879","10259649",0,4,2,1,0,3
"880","10259796",0,4,0,0,0,0
"881","10260260",0,4,1,2,0,3
"882","10260331",0,5,3,0,0,3
"883","10260572",0,5,3,0,0,3
"884","10260613",0,2,0,0,0,0
"885","10260636",0,5,2,0,0,2
"886","10260639",0,1,0,1,0,1
"887","10260677",0,2,1,2,0,3
"888","10260680",0,4,5,0,0,5
"889","10260777",0,4,0,1,0,1
"890","10260868",0,5,2,1,0,3
"891","10260934",0,4,0,2,0,2
"892","10261043",0,4,2,0,0,2
"893","10261153",0,6,7,0,0,7
"894","10261204",0,6,2,0,0,2
"895","10261242",0,5,4,2,0,6
"896","10261333",0,4,0,0,0,0
"897","10261338",0,4,1,0,0,1
"898","10261393",0,4,4,3,0,7
"899","10261501",0,4,6,1,0,7
"900","10261552",0,3,1,3,0,4
"901","10261644",0,7,5,5,1,11
"902","10261653",0,2,0,0,0,0
"903","10261684",0,2,2,0,0,2
"904","10261727",0,5,2,0,0,2
"905","10261787",0,4,0,1,0,1
"906","10261795",0,3,2,1,0,3
"907","10261860",0,6,10,17,2,29
"908","10261957",0,2,0,2,0,2
"909","10261962",0,2,0,0,0,0
"910","10261980",0,2,1,0,0,1
"911","10262127",0,1,0,3,0,3
"912","10262260",0,2,0,0,0,0
"913","10262303",0,5,0,0,0,0
"914","10262307",0,3,0,0,0,0
"915","10262315",0,5,5,2,0,7
"916","10262375",0,3,3,1,0,4
"917","10262596",0,4,0,0,0,0
"918","10262638",0,5,5,1,0,6
"919","10262656",0,3,4,0,0,4
"920","10262677",0,4,0,1,0,1
"921","10262879",0,2,0,0,0,0
"922","10262983",0,2,1,0,0,1
"923","10262985",0,1,0,0,0,0
"924","10263010",0,5,0,0,0,0
"925","10263049",0,4,5,0,0,5
"926","10263097",0,4,5,6,0,11
"927","10263148",0,4,3,1,0,4
"928","10263183",0,4,0,0,0,0
"929","10263191",0,5,0,1,0,1
"930","10263217",0,1,0,0,0,0
"931","10263300",0,3,1,0,0,1
"932","10263306",0,1,0,3,0,3
"933","10263374",0,1,0,0,0,0
"934","10263389",0,1,1,0,0,1
"935","10263407",0,3,0,0,0,0
"936","10263525",0,4,1,0,0,1
"937","10263676",0,2,2,0,0,2
"938","10263766",0,5,1,0,0,1
"939","10263867",0,4,7,0,0,7
"940","10263891",0,4,4,0,0,4
"941","10263911",0,3,8,1,0,9
"942","10263948",0,6,10,7,0,17
"943","10264044",0,3,2,1,0,3
"944","10264327",0,3,3,0,0,3
"945","10264628",0,1,0,0,0,0
"946","10264871",0,3,0,0,0,0
"947","10264943",0,4,0,0,0,0
"948","10264972",0,4,2,1,0,3
"949","10265033",0,6,7,1,0,8
"950","10265111",0,5,4,2,1,7
"951","10265204",0,7,9,11,1,21
"952","10265221",0,2,0,0,0,0
"953","10265254",0,6,0,1,0,1
"954","10265268",1,1,0,0,0,0
"955","10265273",0,5,4,1,0,5
"956","10265356",0,9,8,11,2,21
"957","10265410",0,3,2,7,0,9
"958","10265424",0,1,0,0,0,0
"959","10265558",0,4,4,0,0,4
"960","10265737",0,2,0,0,0,0
"961","10265856",0,6,9,8,0,17
"962","10266004",0,7,12,11,2,25
"963","10266023",0,4,0,0,0,0
"964","10266073",0,3,5,1,0,6
"965","10266132",0,10,9,12,5,26
"966","10266207",0,5,1,2,0,3
"967","10266215",0,4,1,3,0,4
"968","10266224",0,4,0,0,0,0
"969","10266227",0,3,1,0,0,1
"970","10266407",0,2,2,3,0,5
"971","10266523",0,2,0,0,0,0
"972","10266543",0,3,4,2,2,8
"973","10266599",0,3,2,1,0,3
"974","10266652",0,2,1,0,0,1
"975","10266702",0,5,1,1,0,2
"976","10266721",0,6,6,2,0,8
"977","10266756",0,7,1,1,0,2
"978","10266831",0,6,3,0,0,3
"979","10266854",0,3,4,0,0,4
"980","10267064",0,3,0,3,0,3
"981","10267150",0,1,0,0,0,0
"982","10267171",0,1,3,0,0,3
"983","10267221",0,2,0,0,0,0
"984","10267358",0,4,3,1,0,4
"985","10267359",0,5,4,0,0,4
"986","10267416",0,4,5,2,0,7
"987","10267454",0,5,3,9,0,12
"988","10267698",0,2,0,1,0,1
"989","10267711",0,3,0,0,0,0
"990","10267867",0,4,0,3,0,3
"991","10267888",0,1,0,0,0,0
"992","10267941",0,2,0,0,0,0
"993","10267996",0,1,1,0,0,1
"994","10268050",0,7,14,5,1,20
"995","10268065",0,3,1,0,0,1
"996","10268146",1,7,6,5,0,11
"997","10268200",0,3,0,3,0,3
"998","10268207",0,5,0,0,0,0
"999","10268208",1,2,0,0,0,0
"1000","10268229",0,2,0,0,0,0
"1001","10268261",0,2,0,0,0,0
"1002","10268331",0,3,1,0,0,1
"1003","10268340",0,2,2,0,0,2
"1004","10268378",0,6,2,0,0,2
"1005","10268385",0,1,0,0,0,0
"1006","10268400",0,6,9,5,0,14
"1007","10268415",0,4,1,0,0,1
"1008","10268418",0,4,5,2,0,7
"1009","10268497",0,2,2,0,0,2
"1010","10268519",0,1,0,0,0,0
"1011","10268522",0,2,1,6,1,8
"1012","10268531",0,5,2,0,0,2
"1013","10268537",1,4,1,0,0,1
"1014","10268734",0,1,0,1,0,1
"1015","10268933",0,4,1,1,0,2
"1016","10268964",0,4,2,1,0,3
"1017","10268968",0,4,4,2,1,7
"1018","10268993",0,3,0,0,0,0
"1019","10269022",0,5,0,2,0,2
"1020","10269164",0,4,0,0,0,0
"1021","10269214",0,5,2,1,0,3
"1022","10269238",0,3,0,0,0,0
"1023","10269651",0,1,1,1,0,2
"1024","10269660",1,1,0,0,0,0
"1025","10269751",0,3,2,1,0,3
"1026","10269877",0,3,2,0,0,2
"1027","10269905",0,1,0,0,0,0
"1028","10269940",0,4,1,0,0,1
"1029","10270308",0,6,14,1,0,15
"1030","10270349",0,4,3,1,0,4
"1031","10270406",0,2,0,0,0,0
"1032","10270438",0,6,2,0,0,2
"1033","10270634",0,4,1,5,0,6
"1034","10270635",0,1,1,0,0,1
"1035","10270655",0,6,7,5,0,12
"1036","10270719",0,4,0,2,0,2
"1037","10270732",0,3,0,2,0,2
"1038","10270739",0,8,2,3,0,5
"1039","10270740",0,7,2,10,2,14
"1040","10270821",0,5,5,0,0,5
"1041","10270871",0,5,3,2,1,6
"1042","10270893",0,4,1,1,0,2
"1043","10270897",0,2,0,0,0,0
"1044","10270900",0,4,0,0,0,0
"1045","10271028",0,1,0,0,0,0
"1046","10271248",0,4,2,0,0,2
"1047","10271279",0,4,2,1,0,3
"1048","10271280",0,3,3,0,0,3
"1049","10271446",0,4,0,0,0,0
"1050","10271449",0,1,1,0,0,1
"1051","10271778",0,4,2,0,0,2
"1052","10271889",0,5,1,1,0,2
"1053","10271960",0,3,1,1,0,2
"1054","10272090",0,4,2,0,0,2
"1055","10272293",0,6,3,3,0,6
"1056","10272356",0,4,6,0,0,6
"1057","10272398",0,4,3,1,0,4
"1058","10272410",0,4,0,0,0,0
"1059","10272416",0,3,0,0,0,0
"1060","10272429",0,6,0,2,0,2
"1061","10272610",0,5,6,4,0,10
"1062","10272650",0,4,2,3,0,5
"1063","10273109",0,5,4,0,0,4
"1064","10273173",0,3,1,1,0,2
"1065","10273182",0,2,0,0,0,0
"1066","10273310",0,2,0,0,0,0
"1067","10273321",0,3,0,0,0,0
"1068","10273324",0,1,0,0,0,0
"1069","10273475",0,2,2,2,0,4
"1070","10273499",0,7,2,5,0,7
"1071","10273510",0,2,0,0,0,0
"1072","10273586",0,3,0,0,0,0
"1073","10273667",0,3,0,0,0,0
"1074","10273747",0,3,0,1,0,1
"1075","10273750",0,8,3,6,1,10
"1076","10273767",0,1,1,0,0,1
"1077","10273776",0,2,0,0,0,0
"1078","10273995",0,4,2,0,0,2
"1079","10273996",0,4,7,3,0,10
"1080","10274021",0,4,0,1,0,1
"1081","10274027",0,4,1,0,0,1
"1082","10274297",0,1,0,0,0,0
"1083","10274534",0,1,0,0,0,0
"1084","10274551",0,2,3,0,0,3
"1085","10274553",0,1,0,0,0,0
"1086","10274615",0,1,0,0,0,0
"1087","10274769",0,4,0,0,0,0
"1088","10274791",0,3,4,2,0,6
"1089","10274798",0,2,1,0,0,1
"1090","10274874",0,2,0,1,0,1
"1091","10275190",0,4,0,0,0,0
"1092","10275217",0,2,5,3,1,9
"1093","10275278",0,4,7,0,0,7
"1094","10275323",0,7,15,12,4,31
"1095","10275340",0,5,6,3,1,10
"1096","10275385",0,7,19,12,2,33
"1097","10275386",0,3,0,0,0,0
"1098","10275389",0,3,2,0,0,2
"1099","10275393",0,3,1,0,0,1
"1100","10275396",0,2,0,0,0,0
"1101","10275398",0,4,1,2,0,3
"1102","10275441",0,4,3,0,0,3
"1103","10275504",0,5,3,7,1,11
"1104","10275616",0,1,0,0,0,0
"1105","10275656",0,5,1,2,0,3
"1106","10275671",0,3,1,1,0,2
"1107","10275681",0,4,0,0,0,0
"1108","10275685",0,3,1,0,0,1
"1109","10275725",0,3,0,1,0,1
"1110","10275887",0,5,7,2,0,9
"1111","10275898",0,2,2,1,0,3
"1112","10275995",0,6,0,7,2,9
"1113","10276015",0,7,5,1,0,6
"1114","10276266",0,2,1,2,0,3
"1115","10276475",0,4,2,0,1,3
"1116","10276544",0,5,6,2,0,8
"1117","10276758",0,4,1,1,0,2
"1118","10276766",0,4,0,0,0,0
"1119","10276826",0,4,5,0,0,5
"1120","10276897",0,3,5,3,0,8
"1121","10277242",0,5,6,2,0,8
"1122","10277414",0,4,0,0,0,0
"1123","10277500",0,4,5,2,0,7
"1124","10277559",0,2,2,0,0,2
"1125","10277568",0,2,0,1,0,1
"1126","10277589",0,3,1,0,0,1
"1127","10277602",0,4,1,1,0,2
"1128","10277628",0,9,14,9,3,26
"1129","10277964",0,2,3,0,0,3
"1130","10278108",0,4,4,0,0,4
"1131","10278133",0,2,0,0,0,0
"1132","10278139",0,6,0,0,0,0
"1133","10278177",0,4,0,2,0,2
"1134","10278238",0,6,3,0,0,3
"1135","10278335",0,3,3,2,0,5
"1136","10278339",0,3,4,1,0,5
"1137","10278554",0,1,0,0,0,0
"1138","10278687",0,4,12,1,0,13
"1139","10278752",0,2,0,0,0,0
"1140","10278948",0,5,2,0,0,2
"1141","10278960",0,5,8,0,0,8
"1142","10278962",0,5,3,3,2,8
"1143","10279127",0,4,0,0,0,0
"1144","10279215",0,5,3,4,0,7
"1145","10279521",0,6,12,4,0,16
"1146","10279528",1,6,2,0,0,2
"1147","10279614",0,1,0,0,0,0
"1148","10279641",0,4,1,0,0,1
"1149","10279660",0,4,5,2,0,7
"1150","10279717",0,3,0,0,0,0
"1151","10279719",0,3,0,1,0,1
"1152","10279766",0,3,3,0,0,3
"1153","10279813",0,1,0,0,0,0
"1154","10279952",0,4,0,1,0,1
"1155","10279993",0,2,2,2,0,4
"1156","10280020",0,4,2,0,0,2
"1157","10280023",0,4,0,0,0,0
"1158","10280112",0,5,1,4,0,5
"1159","10280126",0,5,1,0,0,1
"1160","10280143",0,2,0,0,0,0
"1161","10280334",0,7,6,4,2,12
"1162","10280426",0,7,5,4,1,10
"1163","10280473",0,2,0,0,0,0
"1164","10280531",0,4,4,1,0,5
"1165","10280558",0,2,0,0,0,0
"1166","10280622",0,11,13,1,1,15
"1167","10280726",0,4,0,0,0,0
"1168","10280728",0,3,3,4,1,8
"1169","10280778",0,3,3,2,0,5
"1170","10280922",0,1,1,0,0,1
"1171","10280924",0,5,0,0,0,0
"1172","10281054",0,4,1,0,0,1
"1173","10281157",0,1,0,0,0,0
"1174","10281293",0,1,2,0,0,2
"1175","10281548",0,1,0,0,0,0
"1176","10281550",0,3,0,0,0,0
"1177","10281564",0,2,0,0,0,0
"1178","10281769",0,4,2,1,2,5
"1179","10281844",0,3,0,0,0,0
"1180","10281856",0,2,3,1,1,5
"1181","10281922",0,1,0,0,0,0
"1182","10282092",0,4,0,0,0,0
"1183","10282109",0,4,1,1,0,2
"1184","10282129",0,4,0,3,0,3
"1185","10282353",0,5,3,6,0,9
"1186","10282476",0,5,0,0,0,0
"1187","10282501",0,15,25,20,7,52
"1188","10282520",0,4,0,0,0,0
"1189","10282526",0,3,0,1,0,1
"1190","10282549",0,3,0,0,0,0
"1191","10282582",0,4,0,0,0,0
"1192","10282716",0,3,4,0,0,4
"1193","10282887",0,4,6,1,0,7
"1194","10282893",0,7,10,6,1,17
"1195","10282900",0,4,0,0,0,0
"1196","10283027",0,2,0,0,0,0
"1197","10283030",0,1,1,0,0,1
"1198","10283046",0,3,0,0,0,0
"1199","10283081",0,3,4,1,0,5
"1200","10283185",0,1,0,0,0,0
"1201","10283196",0,4,0,1,0,1
"1202","10283251",0,8,3,0,0,3
"1203","10283384",0,5,3,3,0,6
"1204","10283578",0,1,0,0,0,0
"1205","10283647",0,1,0,0,0,0
"1206","10283664",0,6,6,1,0,7
"1207","10283743",0,17,12,12,6,30
"1208","10283861",0,2,2,0,0,2
"1209","10283927",0,2,1,0,0,1
"1210","10283978",0,4,0,0,0,0
"1211","10284210",0,1,0,0,0,0
"1212","10284290",0,4,11,2,0,13
"1213","10284419",0,4,1,5,1,7
"1214","10284459",0,2,2,5,0,7
"1215","10284482",0,3,3,3,0,6
"1216","10284603",0,4,7,0,0,7
"1217","10284820",0,4,0,0,0,0
"1218","10284873",0,3,5,2,0,7
"1219","10284989",0,3,5,0,0,5
"1220","10284992",0,4,1,0,0,1
"1221","10285005",0,3,0,0,0,0
"1222","10285237",0,4,2,0,0,2
"1223","10285384",0,1,0,0,0,0
"1224","10285424",0,2,3,0,0,3
"1225","10285460",0,4,7,0,0,7
"1226","10285469",0,3,5,4,0,9
"1227","10285522",0,8,7,3,0,10
"1228","10285581",0,2,1,2,0,3
"1229","10285627",0,4,0,0,0,0
"1230","10285778",0,6,3,1,0,4
"1231","10285961",0,5,5,3,0,8
"1232","10286076",0,4,1,0,0,1
"1233","10286093",0,4,0,0,0,0
"1234","10286099",0,7,8,5,0,13
"1235","10286106",0,6,4,2,0,6
"1236","10286179",0,1,0,0,0,0
"1237","10286233",0,1,0,0,0,0
"1238","10286265",0,3,0,0,0,0
"1239","10286289",0,3,1,0,0,1
"1240","10286382",0,2,0,0,0,0
"1241","10286607",0,1,0,3,0,3
"1242","10286617",0,4,2,2,0,4
"1243","10286665",0,6,4,5,0,9
"1244","10286748",0,4,2,0,0,2
"1245","10286893",0,5,0,0,0,0
"1246","10286899",0,1,0,0,0,0
"1247","10286921",0,4,0,0,0,0
"1248","10286932",0,2,0,0,0,0
"1249","10286954",0,4,0,0,0,0
"1250","10286970",0,3,3,0,0,3
"1251","10287018",0,4,0,0,0,0
"1252","10287045",0,2,0,0,0,0
"1253","10287274",0,4,1,1,0,2
"1254","10287286",0,3,1,2,0,3
"1255","10287338",0,8,9,2,0,11
"1256","10287349",0,5,0,1,0,1
"1257","10287358",0,3,3,3,0,6
"1258","10287399",0,4,5,0,0,5
"1259","10287417",0,3,0,0,0,0
"1260","10287494",0,2,0,0,0,0
"1261","10287545",0,6,3,3,0,6
"1262","10287744",0,3,1,2,0,3
"1263","10287754",0,2,1,0,0,1
"1264","10287767",0,4,2,0,0,2
"1265","10287768",0,3,1,0,0,1
"1266","10287772",0,4,0,0,0,0
"1267","10287943",0,2,4,0,0,4
"1268","10288156",0,1,0,1,0,1
"1269","10288182",0,5,1,0,0,1
"1270","10288191",0,3,0,0,0,0
"1271","10288211",0,3,0,1,0,1
"1272","10288212",0,3,0,0,0,0
"1273","10288213",0,3,1,3,0,4
"1274","10288277",0,3,0,0,0,0
"1275","10288322",0,6,9,3,0,12
"1276","10288439",0,5,2,0,0,2
"1277","10288447",0,3,0,0,0,0
"1278","10288510",0,1,0,0,0,0
"1279","10288525",0,2,0,1,0,1
"1280","10288526",0,1,1,1,0,2
"1281","10288627",0,1,0,0,0,0
"1282","10288692",0,4,5,1,0,6
"1283","10288763",0,10,20,7,1,28
"1284","10288858",0,3,1,0,0,1
"1285","10288862",0,4,2,0,0,2
"1286","10288863",0,4,0,2,0,2
"1287","10288870",0,2,0,0,0,0
"1288","10288885",0,7,10,2,0,12
"1289","10288951",0,2,0,0,0,0
"1290","10288953",0,3,3,1,0,4
"1291","10288961",0,6,1,0,0,1
"1292","10289036",0,1,0,0,0,0
"1293","10289044",0,5,5,3,1,9
"1294","10289049",0,5,3,0,1,4
"1295","10289055",0,2,0,0,0,0
"1296","10289094",0,3,1,0,0,1
"1297","10289132",0,4,0,0,0,0
"1298","10289211",0,2,0,0,0,0
"1299","10289237",0,3,0,0,0,0
"1300","10289271",0,7,0,1,0,1
"1301","10289293",0,1,0,0,0,0
"1302","10289316",0,1,0,0,0,0
"1303","10289348",0,3,0,0,0,0
"1304","10289589",0,4,2,0,0,2
"1305","10289590",0,1,0,0,0,0
"1306","10289695",0,4,2,1,0,3
"1307","10289815",0,5,1,3,0,4
"1308","10289840",0,3,4,0,0,4
"1309","10289849",0,3,1,1,1,3
"1310","10289898",0,4,1,5,0,6
"1311","10289959",0,4,0,0,0,0
"1312","10289965",0,2,0,0,0,0
"1313","10289986",0,1,0,0,0,0
"1314","10290082",0,1,1,0,0,1
"1315","10290101",0,2,1,2,0,3
"1316","10290106",0,10,14,5,1,20
"1317","10290137",0,3,0,3,0,3
"1318","10290147",0,1,0,0,0,0
"1319","10290210",0,3,3,1,0,4
"1320","10290257",0,6,10,1,0,11
"1321","10290305",0,1,0,0,0,0
"1322","10290353",0,6,0,0,0,0
"1323","10290380",0,1,0,0,0,0
"1324","10290426",0,1,0,0,0,0
"1325","10290461",0,2,2,0,0,2
"1326","10290476",0,8,17,7,0,24
"1327","10290524",0,5,0,0,0,0
"1328","10290575",0,4,1,0,0,1
"1329","10290583",0,6,12,3,1,16
"1330","10290615",0,1,0,0,0,0
"1331","10290700",0,6,3,2,0,5
"1332","10290805",0,4,0,0,0,0
"1333","10290812",0,1,0,0,0,0
"1334","10290862",0,1,0,0,0,0
"1335","10290901",0,2,0,4,0,4
"1336","10290946",0,3,1,0,0,1
"1337","10290974",0,5,0,2,0,2
"1338","10290975",0,4,0,0,0,0
"1339","10290978",0,1,0,0,0,0
"1340","10291045",0,7,10,8,3,21
"1341","10291052",0,9,7,11,1,19
"1342","10291064",0,4,1,0,0,1
"1343","10291095",0,1,0,0,0,0
"1344","10291100",0,2,1,0,0,1
"1345","10291163",0,2,0,0,0,0
"1346","10291253",0,6,0,2,0,2
"1347","10291254",0,1,0,0,0,0
"1348","10291284",0,1,0,0,0,0
"1349","10291310",0,2,1,0,0,1
"1350","10291414",0,4,1,0,0,1
"1351","10291437",0,4,12,5,0,17
"1352","10291445",0,5,0,0,1,1
"1353","10291465",0,2,5,2,0,7
"1354","10291530",0,3,1,1,0,2
"1355","10291656",0,6,15,1,0,16
"1356","10291705",0,1,0,0,0,0
"1357","10291713",0,1,0,0,0,0
"1358","10291793",0,2,0,0,0,0
"1359","10291975",0,7,3,1,0,4
"1360","10292136",0,2,1,0,0,1
"1361","10292482",0,1,0,0,0,0
"1362","10292559",0,1,0,0,0,0
"1363","10292572",0,4,6,1,0,7
"1364","10292822",0,7,10,5,0,15
"1365","10292878",0,5,0,0,0,0
"1366","10293086",0,3,0,1,2,3
"1367","10293112",0,2,1,0,0,1
"1368","10293290",0,5,0,0,0,0
"1369","10293292",0,2,4,1,0,5
"1370","10293341",0,5,0,2,0,2
"1371","10293342",0,4,0,0,0,0
"1372","10293387",1,4,0,0,0,0
"1373","10293675",0,4,3,0,0,3
"1374","10293733",0,3,4,0,0,4
"1375","10293768",0,5,6,4,0,10
"1376","10293952",0,4,0,0,0,0
"1377","10294130",0,3,2,1,0,3
"1378","10294199",0,1,1,0,0,1
"1379","10294331",0,5,0,0,0,0
"1380","10294380",0,6,4,3,0,7
"1381","10294398",0,11,17,10,5,32
"1382","10294420",0,2,0,0,0,0
"1383","10294502",0,4,1,0,0,1
"1384","10294514",0,2,0,0,0,0
"1385","10294532",0,1,0,0,0,0
"1386","10294580",0,4,1,2,0,3
"1387","10294608",0,3,6,3,0,9
"1388","10294646",0,6,5,6,0,11
"1389","10294690",0,7,13,4,1,18
"1390","10294881",0,3,2,2,0,4
"1391","10294898",0,9,13,6,3,22
"1392","10294978",0,1,0,0,0,0
"1393","10295046",0,4,3,1,0,4
"1394","10295122",0,4,4,1,0,5
"1395","10295165",0,4,2,2,0,4
"1396","10295281",0,4,9,2,0,11
"1397","10295355",0,5,8,4,2,14
"1398","10295446",0,3,0,0,0,0
"1399","10295647",0,5,1,0,0,1
"1400","10295668",0,4,6,0,0,6
"1401","10295671",0,4,5,0,0,5
"1402","10295683",0,4,2,0,0,2
"1403","10295731",0,6,8,0,0,8
"1404","10295779",0,4,2,1,0,3
"1405","10295976",0,6,3,1,0,4
"1406","10295995",0,4,2,0,0,2
"1407","10296056",0,6,9,5,0,14
"1408","10296060",0,4,3,0,0,3
"1409","10296062",0,4,0,0,0,0
"1410","10296254",0,7,8,5,0,13
"1411","10296275",0,5,5,2,0,7
"1412","10296285",0,3,1,0,0,1
"1413","10296307",0,1,0,0,0,0
"1414","10296339",0,1,1,0,0,1
"1415","10296347",0,7,6,2,0,8
"1416","10296424",0,1,0,0,0,0
"1417","10296437",0,1,0,0,0,0
"1418","10296512",0,4,1,1,0,2
"1419","10296590",0,6,6,3,1,10
"1420","10296659",0,1,0,0,0,0
"1421","10296672",0,6,1,1,0,2
"1422","10296683",0,1,0,0,0,0
"1423","10296699",0,8,11,1,0,12
"1424","10296721",0,2,0,0,0,0
"1425","10296959",0,4,3,1,0,4
"1426","10296969",0,6,6,5,0,11
"1427","10296977",0,1,0,0,0,0
"1428","10297008",0,7,8,11,2,21
"1429","10297263",0,2,0,0,0,0
"1430","10297402",0,1,0,0,0,0
"1431","10297405",0,3,0,0,0,0
"1432","10297419",0,4,1,0,0,1
"1433","10297521",0,2,0,0,0,0
"1434","10297553",0,2,2,0,0,2
"1435","10297563",0,2,0,0,0,0
"1436","10297693",0,5,1,2,0,3
"1437","10297733",0,1,0,0,0,0
"1438","10297817",0,2,1,0,0,1
"1439","10297823",0,4,0,4,0,4
"1440","10297905",0,6,4,1,0,5
"1441","10297939",0,4,2,0,0,2
"1442","10298030",0,7,1,3,2,6
"1443","10298302",0,4,2,0,0,2
"1444","10298375",0,5,3,0,0,3
"1445","10298538",0,4,0,0,0,0
"1446","10298589",0,1,0,0,0,0
"1447","10298610",0,1,0,1,0,1
"1448","10298649",0,3,2,0,0,2
"1449","10298837",0,1,1,0,0,1
"1450","10298881",0,1,1,0,0,1
"1451","10298926",0,4,8,3,0,11
"1452","10298941",0,1,0,0,0,0
"1453","10299120",0,4,0,0,0,0
"1454","10299162",0,9,12,5,5,22
"1455","10299335",0,2,0,0,0,0
"1456","10299357",0,1,0,0,0,0
"1457","10299391",0,1,0,0,0,0
"1458","10299529",0,6,5,1,1,7
"1459","10299616",0,1,0,0,0,0
"1460","10299634",0,4,3,1,0,4
"1461","10299689",0,3,1,0,0,1
"1462","10299781",0,7,6,5,0,11
"1463","10299782",0,4,1,2,0,3
"1464","10299785",0,1,0,0,0,0
"1465","10299814",0,6,6,1,0,7
"1466","10299818",0,2,0,0,0,0
"1467","10299911",0,5,4,3,0,7
"1468","10299924",0,6,5,8,2,15
"1469","10300015",0,2,0,1,0,1
"1470","10300050",1,4,2,2,0,4
"1471","10300054",1,3,1,2,0,3
"1472","10300060",1,3,0,0,0,0
"1473","10300063",1,4,3,0,0,3
"1474","10300065",1,4,3,0,0,3
"1475","10300066",1,4,1,0,0,1
"1476","10300069",1,4,2,2,0,4
"1477","10300071",1,4,1,1,0,2
"1478","10300083",1,4,3,4,0,7
"1479","10300084",1,4,1,2,0,3
"1480","10300086",1,4,1,1,0,2
"1481","10300122",0,7,12,1,1,14
"1482","10300138",0,1,2,0,0,2
"1483","10300225",0,4,0,0,0,0
"1484","10300293",0,3,0,0,0,0
"1485","10300332",0,4,4,0,0,4
"1486","10300360",0,5,3,2,1,6
"1487","10300413",0,4,0,0,0,0
"1488","10300425",0,2,0,0,0,0
"1489","10300481",0,5,8,3,0,11
"1490","10300487",0,2,1,1,0,2
"1491","10300552",0,3,4,1,0,5
"1492","10300596",1,3,1,1,0,2
"1493","10300687",0,2,0,0,0,0
"1494","10300690",0,4,0,0,0,0
"1495","10300701",0,1,0,0,0,0
"1496","10300785",0,7,1,6,1,8
"1497","10300812",0,4,3,4,0,7
"1498","10300820",0,5,5,4,1,10
"1499","10300825",0,4,4,4,0,8
"1500","10300913",0,4,3,2,0,5
"1501","10301153",0,4,0,1,0,1
"1502","10301160",0,1,0,0,0,0
"1503","10301248",0,4,5,3,0,8
"1504","10301403",0,6,8,5,0,13
"1505","10301462",0,3,0,3,0,3
"1506","10301715",0,6,11,6,0,17
"1507","10301889",0,6,9,11,1,21
"1508","10301912",0,1,0,0,0,0
"1509","10301949",0,3,5,3,0,8
"1510","10301979",0,6,8,2,0,10
"1511","10302154",0,4,5,7,0,12
"1512","10302321",0,3,0,0,0,0
"1513","10302426",0,1,0,0,0,0
"1514","10302456",0,5,10,4,1,15
"1515","10302508",0,4,3,3,0,6
"1516","10302558",0,4,0,0,0,0
"1517","10302560",0,4,6,0,0,6
"1518","10302626",0,1,0,0,0,0
"1519","10302690",0,4,1,0,0,1
"1520","10302868",0,1,0,0,0,0
"1521","10302871",0,4,9,2,0,11
"1522","10303111",0,2,1,0,0,1
"1523","10303129",0,4,3,0,0,3
"1524","10303161",0,2,2,0,0,2
"1525","10303232",0,5,11,6,0,17
"1526","10303325",0,5,4,2,0,6
"1527","10303399",0,4,1,1,0,2
"1528","10303500",0,5,0,0,0,0
"1529","10303588",0,3,1,3,0,4
"1530","10303829",0,4,3,0,0,3
"1531","10303833",0,5,1,2,1,4
"1532","10303904",0,9,12,4,4,20
"1533","10303909",0,5,1,2,1,4
"1534","10303915",0,2,0,0,0,0
"1535","10303955",0,4,0,0,0,0
"1536","10304121",0,3,1,0,0,1
"1537","10304251",0,3,1,1,0,2
"1538","10304261",0,3,0,0,0,0
"1539","10304271",0,3,1,0,0,1
"1540","10304285",0,4,0,0,0,0
"1541","10304401",0,9,7,1,1,9
"1542","10304406",0,5,1,0,0,1
"1543","10304434",0,2,0,0,0,0
"1544","10304452",0,3,0,0,0,0
"1545","10304453",0,6,6,0,0,6
"1546","10304517",0,2,0,0,0,0
"1547","10304521",0,3,3,0,0,3
"1548","10304953",0,3,5,2,0,7
"1549","10304970",0,4,5,2,0,7
"1550","10305034",0,3,0,1,0,1
"1551","10305103",0,3,0,0,0,0
"1552","10305107",0,1,1,0,0,1
"1553","10305227",0,4,0,0,0,0
"1554","10305346",0,4,0,0,0,0
"1555","10305408",0,1,0,0,0,0
"1556","10305543",0,3,4,1,0,5
"1557","10305590",0,4,1,2,0,3
"1558","10305728",0,6,5,4,0,9
"1559","10305790",0,4,2,1,1,4
"1560","10305793",0,4,1,0,0,1
"1561","10305802",0,1,0,0,0,0
"1562","10305906",1,5,3,1,0,4
"1563","10306013",0,2,0,0,0,0
"1564","10306091",0,1,0,0,0,0
"1565","10306195",0,2,0,0,0,0
"1566","10306302",0,4,0,0,0,0
"1567","10306320",0,4,2,0,0,2
"1568","10306430",0,1,2,0,0,2
"1569","10306472",0,1,0,0,0,0
"1570","10306553",0,3,0,0,0,0
"1571","10306559",0,1,0,0,0,0
"1572","10306560",0,4,5,1,0,6
"1573","10306585",0,5,0,1,0,1
"1574","10306586",0,1,0,0,0,0
"1575","10306595",0,1,1,0,0,1
"1576","10306801",0,2,0,0,0,0
"1577","10306875",0,4,0,0,0,0
"1578","10306882",0,3,0,0,0,0
"1579","10306933",0,4,0,0,0,0
"1580","10307048",0,7,8,5,0,13
"1581","10307082",0,2,0,0,0,0
"1582","10307086",0,5,3,0,1,4
"1583","10307097",0,2,7,3,0,10
"1584","10307117",0,2,1,0,0,1
"1585","10307146",0,7,13,7,0,20
"1586","10307174",0,3,0,2,0,2
"1587","10307211",0,5,7,8,0,15
"1588","10307265",0,3,0,0,0,0
"1589","10307383",0,3,2,0,0,2
"1590","10307451",0,1,0,0,0,0
"1591","10307542",0,2,1,4,0,5
"1592","10307666",0,1,0,0,0,0
"1593","10307901",0,4,2,8,0,10
"1594","10307907",0,5,12,5,0,17
"1595","10307968",0,4,0,0,0,0
"1596","10307992",0,1,0,0,0,0
"1597","10308169",0,3,1,0,0,1
"1598","10308247",0,7,9,4,1,14
"1599","10308442",0,5,1,0,0,1
"1600","10308527",0,6,2,1,0,3
"1601","10308605",0,5,2,0,0,2
"1602","10308654",0,7,5,5,0,10
"1603","10308657",0,4,6,5,0,11
"1604","10308668",0,1,0,0,0,0
"1605","10308671",0,4,0,0,0,0
"1606","10308676",0,5,0,2,0,2
"1607","10308831",0,4,0,0,0,0
"1608","10308846",0,1,0,0,0,0
"1609","10308854",0,3,0,0,0,0
"1610","10308965",0,3,0,0,0,0
"1611","10309000",0,1,0,0,0,0
"1612","10309042",0,1,0,0,0,0
"1613","10309050",0,1,0,0,0,0
"1614","10309080",0,2,0,0,0,0
"1615","10309251",0,5,4,2,3,9
"1616","10309288",1,7,7,2,0,9
"1617","10309303",0,1,0,0,0,0
"1618","10309308",0,1,0,0,0,0
"1619","10309376",0,5,2,3,1,6
"1620","10309532",0,4,1,0,0,1
"1621","10309616",0,3,1,0,0,1
"1622","10310044",0,4,3,1,0,4
"1623","10310113",0,1,0,0,0,0
"1624","10310261",0,4,2,1,0,3
"1625","10310364",0,1,0,0,0,0
"1626","10310520",0,8,11,3,0,14
"1627","10310777",0,4,2,2,0,4
"1628","10310908",0,4,5,2,0,7
"1629","10310950",0,10,4,7,2,13
"1630","10310954",0,3,0,1,0,1
"1631","10310976",0,2,0,0,0,0
"1632","10311154",0,1,0,0,0,0
"1633","10311480",0,3,2,0,0,2
"1634","10311684",0,4,0,0,0,0
"1635","10311693",0,2,0,0,0,0
"1636","10311702",0,6,6,7,0,13
"1637","10311750",0,3,0,0,0,0
"1638","10311924",0,2,0,0,0,0
"1639","10311994",0,3,0,0,0,0
"1640","10312044",0,5,5,0,0,5
"1641","10312078",0,6,8,3,0,11
"1642","10312130",0,3,2,1,0,3
"1643","10312132",0,5,7,2,0,9
"1644","10312732",0,4,0,0,0,0
"1645","10312757",0,2,0,1,0,1
"1646","10312766",0,4,7,1,0,8
"1647","10312885",0,1,0,0,0,0
"1648","10313438",0,4,3,1,0,4
"1649","10313762",0,3,2,1,0,3
"1650","10314133",0,2,0,0,0,0
"1651","10314199",0,13,8,17,3,28
"1652","10314207",0,4,2,1,0,3
"1653","10314323",0,1,0,0,0,0
"1654","10314405",0,5,3,3,0,6
"1655","10314559",0,4,0,2,0,2
"1656","10315084",0,1,0,0,0,0
"1657","10315167",0,9,10,15,3,28
"1658","10315168",0,2,0,0,0,0
"1659","10315176",0,4,3,0,0,3
"1660","10315310",0,7,10,14,5,29
"1661","10315488",0,4,6,4,0,10
"1662","10315506",0,4,0,0,0,0
"1663","10315713",0,3,2,1,0,3
"1664","10315866",0,7,6,6,0,12
"1665","10315899",0,1,0,0,0,0
"1666","10315908",0,4,3,3,0,6
"1667","10315960",0,2,0,0,0,0
"1668","10316062",0,1,0,0,0,0
"1669","10316108",0,1,0,0,0,0
"1670","10316223",0,3,4,3,0,7
"1671","10316225",0,2,3,1,0,4
"1672","10316297",0,2,2,3,0,5
"1673","10316494",1,5,1,0,0,1
"1674","10316709",0,1,0,0,0,0
"1675","10316753",0,4,0,0,0,0
"1676","10316872",0,2,0,2,0,2
"1677","10316902",0,6,8,1,0,9
"1678","10317024",0,5,1,1,0,2
"1679","10317026",0,6,0,1,0,1
"1680","10317494",0,2,0,0,0,0
"1681","10317514",0,4,10,1,0,11
"1682","10317531",0,2,1,0,0,1
"1683","10317539",0,1,1,1,0,2
"1684","10317625",0,1,0,0,0,0
"1685","10317747",0,6,1,3,0,4
"1686","10317874",0,5,6,2,0,8
"1687","10317997",0,4,0,0,0,0
"1688","10318004",0,4,0,3,0,3
"1689","10318016",0,1,0,0,0,0
"1690","10318159",0,4,1,2,0,3
"1691","10318164",0,3,0,1,0,1
"1692","10318395",0,4,0,2,0,2
"1693","10318422",0,9,10,14,2,26
"1694","10318494",0,4,0,0,0,0
"1695","10318495",0,4,2,0,0,2
"1696","10318553",0,3,2,0,0,2
"1697","10318563",0,3,0,0,0,0
"1698","10318598",0,3,0,0,0,0
"1699","10318603",0,1,0,0,0,0
"1700","10318628",0,3,0,0,0,0
"1701","10318630",0,6,5,0,0,5
"1702","10318649",0,3,1,0,0,1
"1703","10318785",0,4,1,1,0,2
"1704","10318893",0,4,8,2,0,10
"1705","10318941",0,4,0,0,0,0
"1706","10318992",0,6,8,9,1,18
"1707","10319035",0,4,0,0,0,0
"1708","10319060",0,4,0,0,0,0
"1709","10319067",0,1,0,0,0,0
"1710","10319141",0,6,4,3,1,8
"1711","10319301",0,5,0,2,0,2
"1712","10319313",0,1,0,0,0,0
"1713","10319327",0,2,0,0,0,0
"1714","10319449",0,4,2,6,0,8
"1715","10319501",0,1,0,0,0,0
"1716","10319713",0,4,4,1,0,5
"1717","10319734",0,3,2,1,0,3
"1718","10319751",0,3,0,2,0,2
"1719","10319757",0,1,0,0,0,0
"1720","10319914",0,2,0,1,0,1
"1721","10319939",0,4,1,1,0,2
"1722","10319999",0,1,0,0,0,0
"1723","10320165",0,4,6,0,0,6
"1724","10320172",1,8,8,9,2,19
"1725","10320301",0,2,0,0,0,0
"1726","10320338",0,6,0,0,0,0
"1727","10320375",0,4,2,2,0,4
"1728","10320412",0,4,2,0,0,2
"1729","10320424",0,2,0,1,0,1
"1730","10320522",0,1,2,1,0,3
"1731","10320589",0,6,1,0,0,1
"1732","10321708",0,4,0,1,0,1
"1733","10321713",0,4,0,1,0,1
"1734","10321715",0,6,2,0,0,2
"1735","10321726",0,6,4,4,1,9
"1736","10321737",0,4,2,7,0,9
"1737","10321764",0,3,0,2,0,2
"1738","10321778",0,1,0,0,0,0
"1739","10321800",0,6,12,1,0,13
"1740","10321868",0,4,0,1,0,1
"1741","10321908",0,4,1,0,0,1
"1742","10322079",0,3,0,0,0,0
"1743","10322134",0,3,2,0,0,2
"1744","10322151",0,7,4,8,1,13
"1745","10322187",0,3,6,0,0,6
"1746","10322215",0,1,0,0,0,0
"1747","10322239",0,5,0,0,0,0
"1748","10322249",0,6,4,0,0,4
"1749","10322381",0,6,4,9,0,13
"1750","10322385",0,3,0,0,0,0
"1751","10322435",0,5,5,6,1,12
"1752","10322467",0,7,5,4,0,9
"1753","10322526",0,4,0,0,0,0
"1754","10322540",0,5,2,5,0,7
"1755","10322542",0,1,0,0,0,0
"1756","10322588",0,6,9,0,0,9
"1757","10322624",0,4,1,0,0,1
"1758","10322637",0,6,5,2,0,7
"1759","10322658",0,1,0,0,0,0
"1760","10322778",0,4,3,1,0,4
"1761","10322833",0,4,0,0,0,0
"1762","10322893",0,4,0,0,0,0
"1763","10322928",0,5,4,2,0,6
"1764","10322929",0,4,3,1,0,4
"1765","10322931",0,3,4,0,0,4
"1766","10322932",0,11,2,4,0,6
"1767","10323114",0,4,0,0,0,0
"1768","10323198",0,4,3,2,0,5
"1769","10323232",0,2,0,0,0,0
"1770","10323245",0,2,0,0,0,0
"1771","10323256",0,4,0,0,0,0
"1772","10323272",0,9,7,3,1,11
"1773","10323383",0,1,0,0,0,0
"1774","10323404",0,1,0,0,0,0
"1775","10323463",0,4,3,2,0,5
"1776","10323537",0,2,0,0,0,0
"1777","10323604",0,6,0,1,0,1
"1778","10323607",0,4,4,0,0,4
"1779","10323650",0,4,0,1,0,1
"1780","10323672",0,1,0,0,0,0
"1781","10323682",0,5,3,1,0,4
"1782","10323697",0,4,6,4,0,10
"1783","10323706",0,3,1,0,0,1
"1784","10323713",0,4,2,0,0,2
"1785","10323714",0,6,3,3,2,8
"1786","10323716",0,1,0,0,0,0
"1787","10323717",0,3,0,0,0,0
"1788","10323729",0,1,0,0,0,0
"1789","10323814",0,2,0,0,0,0
"1790","10323905",0,6,10,4,0,14
"1791","10323920",0,2,2,0,0,2
"1792","10323945",0,4,4,0,0,4
"1793","10323995",0,1,0,0,0,0
"1794","10323996",0,6,4,1,0,5
"1795","10324073",0,3,0,0,0,0
"1796","10324107",0,3,1,1,0,2
"1797","10324176",0,4,0,0,0,0
"1798","10324203",0,6,18,13,4,35
"1799","10324284",0,3,5,0,0,5
"1800","10324305",1,5,2,1,0,3
"1801","10324555",0,4,5,0,0,5
"1802","10324613",0,6,8,6,0,14
"1803","10324643",0,1,0,0,0,0
"1804","10324646",0,1,0,0,0,0
"1805","10324649",0,1,0,0,0,0
"1806","10324659",0,5,0,0,0,0
"1807","10324678",0,4,0,0,0,0
"1808","10324680",0,5,9,1,0,10
"1809","10324721",0,1,0,0,0,0
"1810","10324725",0,8,8,10,2,20
"1811","10324798",0,1,0,0,0,0
"1812","10324800",0,1,0,0,0,0
"1813","10324960",0,5,7,3,0,10
"1814","10325002",0,4,0,1,0,1
"1815","10325006",0,2,0,0,0,0
"1816","10325032",0,5,0,0,0,0
"1817","10325036",0,6,2,3,2,7
"1818","10325079",0,2,0,0,0,0
"1819","10325092",0,2,3,1,0,4
"1820","10325162",0,1,0,0,0,0
"1821","10325230",0,2,0,0,0,0
"1822","10325268",0,3,3,1,0,4
"1823","10325286",0,4,4,0,0,4
"1824","10325289",0,2,0,0,0,0
"1825","10325298",0,4,5,5,0,10
"1826","10325310",0,4,6,0,0,6
"1827","10325505",0,4,2,1,0,3
"1828","10325670",0,2,0,0,0,0
"1829","10325685",0,1,2,0,0,2
"1830","10325697",0,3,0,1,0,1
"1831","10325719",1,4,1,1,0,2
"1832","10325721",1,4,0,0,0,0
"1833","10325728",1,4,0,1,0,1
"1834","10325730",1,4,3,1,0,4
"1835","10325734",1,4,0,1,0,1
"1836","10325736",1,5,4,0,0,4
"1837","10325744",0,1,0,0,0,0
"1838","10325790",0,4,0,0,0,0
"1839","10325792",0,1,1,1,0,2
"1840","10325820",0,3,5,2,0,7
"1841","10325846",0,1,1,0,0,1
"1842","10325864",0,2,0,1,0,1
"1843","10325891",0,3,0,4,1,5
"1844","10326001",0,3,0,0,0,0
"1845","10326025",0,4,1,3,0,4
"1846","10326044",0,3,1,1,0,2
"1847","10326080",0,6,5,3,2,10
"1848","10326108",0,2,0,1,0,1
"1849","10326118",0,1,0,0,0,0
"1850","10326177",0,1,3,0,0,3
"1851","10326186",0,3,3,1,0,4
"1852","10326205",0,7,11,5,1,17
"1853","10326237",0,3,0,0,0,0
"1854","10326395",0,3,0,0,0,0
"1855","10326468",0,1,0,0,0,0
"1856","10326487",0,1,0,0,0,0
"1857","10326488",0,1,1,0,0,1
"1858","10326506",0,1,0,0,0,0
"1859","10326529",0,4,0,2,0,2
"1860","10326538",0,4,2,0,0,2
"1861","10326563",0,1,1,0,0,1
"1862","10326576",0,2,0,0,0,0
"1863","10326604",0,7,6,5,0,11
"1864","10326714",0,2,0,0,0,0
"1865","10326715",0,3,2,0,0,2
"1866","10326728",0,4,7,0,0,7
"1867","10326829",0,4,7,4,0,11
"1868","10326843",0,1,1,0,0,1
"1869","10326853",0,2,1,1,0,2
"1870","10326909",0,4,0,0,0,0
"1871","10326929",0,2,0,1,0,1
"1872","10327020",0,1,0,0,0,0
"1873","10327050",0,1,2,0,0,2
"1874","10327062",0,4,6,1,0,7
"1875","10327339",0,1,1,0,0,1
"1876","10327370",0,1,0,0,0,0
"1877","10327382",0,1,0,0,0,0
"1878","10327386",0,2,0,0,0,0
"1879","10327402",0,2,3,0,0,3
"1880","10327501",0,1,0,0,0,0
"1881","10327553",0,3,6,1,0,7
"1882","10327561",0,1,0,0,0,0
"1883","10327569",0,6,12,5,0,17
"1884","10327609",0,4,1,0,0,1
"1885","10327617",0,2,0,0,0,0
"1886","10327625",0,2,0,0,0,0
"1887","10327629",0,4,5,2,0,7
"1888","10327638",0,2,0,0,0,0
"1889","10327712",0,4,4,1,0,5
"1890","10327736",0,6,0,0,0,0
"1891","10327775",0,1,0,0,0,0
"1892","10327884",0,1,0,0,0,0
"1893","10327955",0,3,3,0,0,3
"1894","10327970",0,3,0,0,0,0
"1895","10327987",0,7,12,7,0,19
"1896","10328089",0,1,0,0,0,0
"1897","10328143",0,4,1,0,0,1
"1898","10328218",0,1,0,0,0,0
"1899","10328232",0,4,1,0,0,1
"1900","10328276",0,6,2,2,0,4
"1901","10328392",0,4,0,0,0,0
"1902","10328461",0,4,1,0,0,1
"1903","10328464",0,4,3,0,0,3
"1904","10328499",0,4,0,0,0,0
"1905","10328534",0,7,7,7,0,14
"1906","10328537",1,4,1,0,0,1
"1907","10328629",0,3,0,0,0,0
"1908","10328704",0,1,0,0,0,0
"1909","10328787",0,6,5,2,0,7
"1910","10328951",0,6,11,7,0,18
"1911","10328991",0,4,3,1,0,4
"1912","10329042",0,8,1,2,0,3
"1913","10329079",0,1,0,0,0,0
"1914","10329111",0,2,0,0,0,0
"1915","10329113",0,1,0,0,0,0
"1916","10329129",0,2,4,3,0,7
"1917","10329136",0,4,0,0,0,0
"1918","10329175",0,3,0,0,0,0
"1919","10329227",0,3,7,0,0,7
"1920","10329248",0,3,0,0,0,0
"1921","10329348",0,2,0,0,0,0
"1922","10329376",0,4,1,0,0,1
"1923","10329389",0,4,5,0,0,5
"1924","10329521",0,4,3,0,0,3
"1925","10329523",0,5,1,0,0,1
"1926","10329536",0,4,5,1,0,6
"1927","10329547",0,3,0,2,0,2
"1928","10329567",0,2,0,0,0,0
"1929","10329589",0,5,0,0,0,0
"1930","10329592",0,5,10,5,0,15
"1931","10329666",0,6,1,2,1,4
"1932","10329765",0,4,5,1,0,6
"1933","10329769",0,1,0,0,0,0
"1934","10329775",0,4,0,0,0,0
"1935","10329786",0,4,3,1,1,5
"1936","10329938",0,4,7,1,0,8
"1937","10329940",0,5,0,0,0,0
"1938","10329969",0,7,12,8,0,20
"1939","10330022",0,4,0,0,0,0
"1940","10330086",0,3,1,0,0,1
"1941","10330091",0,2,0,0,0,0
"1942","10330133",1,4,2,3,0,5
"1943","10330157",0,4,3,0,0,3
"1944","10330229",0,4,2,1,0,3
"1945","10330268",0,2,2,1,0,3
"1946","10330303",0,6,0,0,0,0
"1947","10330305",0,3,3,0,0,3
"1948","10330511",0,4,3,0,0,3
"1949","10330522",0,4,6,3,0,9
"1950","10330575",0,2,0,0,0,0
"1951","10330614",0,1,2,0,0,2
"1952","10330753",0,4,3,2,0,5
"1953","10330788",0,3,1,0,0,1
"1954","10330843",0,5,3,6,0,9
"1955","10330854",0,5,5,0,0,5
"1956","10330880",0,4,0,0,0,0
"1957","10330891",1,4,3,0,0,3
"1958","10330988",0,1,0,0,0,0
"1959","10331259",0,3,0,0,0,0
"1960","10331262",0,4,1,0,0,1
"1961","10331291",1,1,0,0,0,0
"1962","10331300",0,7,9,2,1,12
"1963","10331342",0,5,1,0,0,1
"1964","10331360",0,3,0,0,0,0
"1965","10331461",0,2,2,0,0,2
"1966","10331556",0,2,6,0,0,6
"1967","10331649",0,6,1,1,0,2
"1968","10331707",1,4,0,0,0,0
"1969","10331809",0,2,0,0,0,0
"1970","10331811",0,2,0,0,0,0
"1971","10331991",0,5,6,4,0,10
"1972","10332007",0,6,8,2,0,10
"1973","10332080",0,5,4,2,0,6
"1974","10332092",0,1,0,0,0,0
"1975","10332094",0,4,5,1,0,6
"1976","10332101",0,3,1,0,0,1
"1977","10332127",1,5,8,3,0,11
"1978","10332140",0,5,0,0,1,1
"1979","10332148",0,1,1,0,0,1
"1980","10332179",0,4,6,2,0,8
"1981","10332280",0,1,0,0,0,0
"1982","10332355",0,3,2,4,0,6
"1983","10332437",0,3,6,4,0,10
"1984","10332459",0,6,5,8,0,13
"1985","10332581",0,3,5,1,0,6
"1986","10332722",0,2,2,0,0,2
"1987","10332835",0,2,0,0,0,0
"1988","10332932",0,4,2,3,0,5
"1989","10332939",0,4,0,0,0,0
"1990","10332956",0,4,1,2,0,3
"1991","10332957",0,3,1,0,0,1
"1992","10332976",0,2,0,0,0,0
"1993","10333074",0,5,0,0,0,0
"1994","10333174",0,4,1,1,0,2
"1995","10333262",0,1,0,0,0,0
"1996","10333380",0,2,1,1,0,2
"1997","10333420",0,5,4,7,0,11
"1998","10333451",0,6,6,2,0,8
"1999","10333481",0,4,2,0,0,2
"2000","10333486",0,1,0,0,0,0
"2001","10333534",0,4,0,0,0,0
"2002","10333589",0,4,4,3,2,9
"2003","10333675",0,3,1,0,0,1
"2004","10333841",0,5,1,1,0,2
"2005","10333880",0,2,0,0,0,0
"2006","10333957",0,4,2,0,0,2
"2007","10334029",0,6,12,3,0,15
"2008","10334030",0,6,11,4,1,16
"2009","10334117",0,6,3,2,0,5
"2010","10334224",0,5,5,3,0,8
"2011","10334437",0,5,1,6,0,7
"2012","10334550",0,4,0,0,0,0
"2013","10334585",1,4,1,3,0,4
"2014","10334587",0,4,3,1,0,4
"2015","10334647",1,4,0,0,0,0
"2016","10334651",1,2,0,0,0,0
"2017","10334654",1,3,0,0,0,0
"2018","10334676",1,3,0,1,0,1
"2019","10334767",0,6,3,3,1,7
"2020","10334786",1,4,2,1,0,3
"2021","10334795",1,3,0,0,0,0
"2022","10334797",0,5,4,2,0,6
"2023","10334864",0,6,0,4,0,4
"2024","10334944",0,4,0,0,0,0
"2025","10334961",0,3,5,3,0,8
"2026","10335035",0,3,1,6,0,7
"2027","10335067",0,4,1,0,0,1
"2028","10335091",0,1,1,0,0,1
"2029","10335240",0,4,4,4,0,8
"2030","10335452",0,3,1,0,0,1
"2031","10335454",0,4,2,1,0,3
"2032","10335485",0,6,3,8,0,11
"2033","10335565",0,3,3,1,0,4
"2034","10335639",0,6,5,4,0,9
"2035","10335825",0,3,0,0,0,0
"2036","10335829",0,1,0,0,0,0
"2037","10335838",0,4,0,0,0,0
"2038","10335938",0,1,0,0,0,0
"2039","10335960",0,4,7,2,0,9
"2040","10336015",0,9,3,5,0,8
"2041","10336016",0,3,4,1,0,5
"2042","10336033",0,1,0,0,0,0
"2043","10336062",0,4,0,0,0,0
"2044","10336135",0,4,0,0,0,0
"2045","10336138",0,1,0,0,0,0
"2046","10336231",0,4,9,3,0,12
"2047","10336494",0,5,5,2,0,7
"2048","10336522",0,13,20,19,4,43
"2049","10336528",0,4,0,1,0,1
"2050","10336535",0,4,7,0,0,7
"2051","10336594",0,3,0,0,0,0
"2052","10336645",0,4,2,0,0,2
"2053","10336669",0,6,4,1,0,5
"2054","10336708",0,4,1,0,0,1
"2055","10336736",0,1,0,0,0,0
"2056","10336795",0,4,4,0,0,4
"2057","10336814",0,4,1,0,0,1
"2058","10336827",0,4,5,4,0,9
"2059","10336829",0,6,8,0,0,8
"2060","10336833",0,4,5,2,0,7
"2061","10336867",0,4,3,1,0,4
"2062","10336894",0,1,0,0,0,0
"2063","10336973",0,3,2,2,0,4
"2064","10337128",0,3,2,0,0,2
"2065","10337142",0,2,2,1,0,3
"2066","10337192",0,4,0,0,0,0
"2067","10337261",0,2,3,1,0,4
"2068","10337343",0,7,6,2,0,8
"2069","10337415",0,5,1,0,0,1
"2070","10337443",0,1,0,0,0,0
"2071","10337527",0,4,2,0,0,2
"2072","10337654",0,4,0,0,0,0
"2073","10337716",0,1,0,0,0,0
"2074","10337825",0,1,2,0,0,2
"2075","10337881",0,4,0,0,0,0
"2076","10338011",0,7,3,7,1,11
"2077","10338020",0,5,3,3,0,6
"2078","10338886",0,6,3,2,0,5
"2079","10339093",0,5,6,5,0,11
"2080","10339311",0,5,2,3,0,5
"2081","10339351",1,1,0,0,0,0
"2082","10339381",0,3,2,0,0,2
"2083","10339382",1,5,0,1,0,1
"2084","10339512",0,6,4,6,0,10
"2085","10339685",0,3,2,2,0,4
"2086","10339687",0,3,3,1,0,4
"2087","10339689",0,4,4,2,0,6
"2088","10339775",0,6,1,6,3,10
"2089","10339794",0,2,1,0,0,1
"2090","10339808",0,3,5,1,0,6
"2091","10339866",0,4,6,0,0,6
"2092","10340010",0,2,2,0,0,2
"2093","10340029",1,2,0,1,0,1
"2094","10340065",1,2,0,0,0,0
"2095","10340075",0,2,0,0,0,0
"2096","10340107",1,1,0,0,0,0
"2097","10340380",0,2,0,2,0,2
"2098","10340404",0,3,4,0,0,4
"2099","10340445",0,4,5,2,0,7
"2100","10340529",0,5,6,1,0,7
"2101","10340654",1,2,0,0,0,0
"2102","10340699",0,1,0,0,0,0
"2103","10340734",0,5,2,2,1,5
"2104","10340749",0,5,4,5,0,9
"2105","10340852",0,2,0,0,0,0
"2106","10340882",0,1,1,0,0,1
"2107","10340911",0,5,4,0,0,4
"2108","10340922",0,6,7,1,0,8
"2109","10340963",1,4,0,1,0,1
"2110","10340995",0,3,0,1,0,1
"2111","10341043",0,2,0,0,0,0
"2112","10341068",0,1,0,0,0,0
"2113","10341089",0,5,0,0,0,0
"2114","10341098",0,2,0,0,0,0
"2115","10341107",0,4,0,0,0,0
"2116","10341140",0,1,0,1,0,1
"2117","10341192",0,5,3,2,0,5
"2118","10341260",0,4,1,0,0,1
"2119","10341262",0,1,0,0,0,0
"2120","10341273",0,1,0,0,0,0
"2121","10341479",0,4,0,0,0,0
"2122","10341486",0,4,6,3,0,9
"2123","10341563",0,2,0,0,0,0
"2124","10341577",0,5,0,0,0,0
"2125","10341588",0,3,2,0,0,2
"2126","10341619",0,12,7,15,0,22
"2127","10341717",0,4,6,3,0,9
"2128","10341748",0,6,10,4,0,14
"2129","10341810",0,6,0,2,1,3
"2130","10341811",0,4,0,0,0,0
"2131","10341820",0,5,0,6,3,9
"2132","10341848",0,5,1,0,0,1
"2133","10341988",0,1,0,0,0,0
"2134","10342246",0,1,0,0,0,0
"2135","10342259",0,7,5,2,0,7
"2136","10342266",0,4,3,1,0,4
"2137","10342334",0,4,0,0,0,0
"2138","10342343",0,4,0,0,0,0
"2139","10342495",0,3,0,0,0,0
"2140","10342496",0,1,0,0,0,0
"2141","10342498",0,3,1,0,0,1
"2142","10342515",0,8,10,3,0,13
"2143","10342516",0,6,12,2,0,14
"2144","10342542",0,5,4,0,0,4
"2145","10342561",0,1,0,0,0,0
"2146","10342871",0,1,3,0,0,3
"2147","10343241",0,4,2,0,0,2
"2148","10343521",0,3,0,0,0,0
"2149","10343811",0,4,1,2,0,3
"2150","10343917",0,2,1,0,0,1
"2151","10343964",0,3,6,1,0,7
"2152","10344005",0,3,0,1,0,1
"2153","10344210",0,7,6,7,4,17
"2154","10344270",0,5,0,0,0,0
"2155","10344276",0,2,0,0,0,0
"2156","10344485",0,4,0,0,0,0
"2157","10344634",0,6,2,0,0,2
"2158","10344647",0,4,0,0,0,0
"2159","10344665",0,2,0,0,0,0
"2160","10344688",0,2,0,0,0,0
"2161","10344741",0,3,2,0,0,2
"2162","10344794",0,3,0,0,0,0
"2163","10344833",0,1,0,0,0,0
"2164","10344845",0,4,5,1,0,6
"2165","10344912",0,5,5,4,0,9
"2166","10344916",0,6,5,4,1,10
"2167","10344939",0,5,0,2,0,2
"2168","10345146",0,4,0,2,0,2
"2169","10345163",0,1,0,0,0,0
"2170","10345244",0,3,1,1,0,2
"2171","10345313",0,4,2,0,0,2
"2172","10345349",0,1,1,0,0,1
"2173","10345388",0,11,9,3,3,15
"2174","10345392",0,8,4,8,0,12
"2175","10345410",0,7,12,8,1,21
"2176","10345413",0,6,1,0,0,1
"2177","10345422",0,4,2,0,0,2
"2178","10345503",0,3,0,0,0,0
"2179","10345571",0,3,1,0,0,1
"2180","10345578",0,4,7,1,0,8
"2181","10345579",0,3,1,0,0,1
"2182","10345766",0,4,0,0,0,0
"2183","10345831",0,5,7,1,0,8
"2184","10345846",0,4,4,1,0,5
"2185","10345894",0,1,0,1,0,1
"2186","10346012",0,2,0,0,0,0
"2187","10346180",0,1,2,2,0,4
"2188","10346491",0,5,0,0,0,0
"2189","10346539",0,5,2,0,0,2
"2190","10346661",0,2,0,2,0,2
"2191","10346781",0,3,0,0,0,0
"2192","10346940",0,6,11,12,0,23
"2193","10347066",0,4,0,1,0,1
"2194","10347094",0,8,17,8,3,28
"2195","10347149",0,10,9,12,0,21
"2196","10347210",0,5,10,0,0,10
"2197","10347246",0,3,0,0,0,0
"2198","10347267",0,3,2,0,0,2
"2199","10347271",0,7,8,7,0,15
"2200","10347285",1,6,0,0,0,0
"2201","10347395",0,4,0,0,0,0
"2202","10347481",0,9,14,4,1,19
"2203","10347689",0,4,2,0,0,2
"2204","10347718",0,5,2,0,0,2
"2205","10347755",0,1,0,0,0,0
"2206","10347882",0,4,3,0,0,3
"2207","10347893",0,4,1,0,0,1
"2208","10347903",0,4,0,0,0,0
"2209","10347922",0,7,1,1,0,2
"2210","10347960",0,1,0,0,0,0
"2211","10348035",0,3,0,1,0,1
"2212","10348080",0,3,0,0,0,0
"2213","10348161",0,5,2,0,0,2
"2214","10348243",0,1,0,0,0,0
"2215","10348267",0,4,5,5,0,10
"2216","10348300",0,2,3,1,0,4
"2217","10348304",0,4,1,0,0,1
"2218","10348305",0,3,1,0,0,1
"2219","10348324",1,4,1,0,0,1
"2220","10348402",0,4,7,2,0,9
"2221","10348416",0,2,2,0,0,2
"2222","10348496",0,2,0,0,0,0
"2223","10348511",0,3,1,9,0,10
"2224","10348513",0,5,1,1,0,2
"2225","10348515",0,2,1,0,0,1
"2226","10348572",0,4,2,0,0,2
"2227","10348575",0,1,0,0,0,0
"2228","10348729",0,6,9,1,0,10
"2229","10348735",0,3,0,0,0,0
"2230","10348748",0,5,6,0,0,6
"2231","10348759",0,4,0,0,0,0
"2232","10348791",0,8,9,4,1,14
"2233","10348809",0,4,1,1,0,2
"2234","10348956",0,5,2,0,0,2
"2235","10349048",0,5,1,0,0,1
"2236","10349076",0,6,7,4,0,11
"2237","10349142",0,2,0,0,0,0
"2238","10349161",0,2,1,0,0,1
"2239","10349204",0,6,4,1,0,5
"2240","10349216",1,3,0,0,0,0
"2241","10349251",0,4,1,0,0,1
"2242","10349260",0,8,1,7,1,9
"2243","10349312",0,4,4,1,0,5
"2244","10349351",0,3,0,0,0,0
"2245","10349357",0,1,0,0,0,0
"2246","10349362",0,9,15,11,1,27
"2247","10349433",0,2,0,0,0,0
"2248","10349521",0,1,0,0,0,0
"2249","10349547",0,2,0,0,0,0
"2250","10349554",0,1,0,0,0,0
"2251","10349599",1,4,2,0,0,2
"2252","10349645",0,5,8,8,0,16
"2253","10349658",0,3,0,0,0,0
"2254","10349666",0,3,7,2,0,9
"2255","10349682",0,7,8,1,0,9
"2256","10349685",0,1,0,0,0,0
"2257","10349719",0,5,1,0,0,1
"2258","10349732",0,4,0,0,0,0
"2259","10349749",0,6,7,3,0,10
"2260","10349787",0,5,7,1,0,8
"2261","10349797",0,2,0,0,0,0
"2262","10349818",0,2,1,0,0,1
"2263","10349828",0,4,0,0,0,0
"2264","10349866",0,3,0,0,0,0
"2265","10349876",0,4,5,0,0,5
"2266","10349928",0,4,0,0,0,0
"2267","10349947",0,1,0,0,0,0
"2268","10349957",0,1,0,0,0,0
"2269","10349959",1,4,0,0,0,0
"2270","10349966",0,4,3,3,0,6
"2271","10350001",0,9,9,5,3,17
"2272","10350022",0,4,0,1,0,1
"2273","10350079",0,2,6,0,0,6
"2274","10350099",0,5,1,0,0,1
"2275","10350133",0,1,1,1,0,2
"2276","10350227",0,4,1,0,0,1
"2277","10350305",0,6,1,1,0,2
"2278","10350323",0,4,3,0,0,3
"2279","10350334",0,3,1,0,0,1
"2280","10350339",0,2,0,0,0,0
"2281","10350359",0,6,2,2,0,4
"2282","10350400",0,2,0,0,0,0
"2283","10350429",0,5,2,2,0,4
"2284","10350432",0,2,0,0,0,0
"2285","10350517",0,4,2,0,0,2
"2286","10350587",0,3,0,3,0,3
"2287","10350652",0,1,0,0,0,0
"2288","10350682",0,4,3,1,0,4
"2289","10350692",0,4,0,0,0,0
"2290","10350706",0,1,0,0,0,0
"2291","10350803",0,3,0,0,0,0
"2292","10350894",0,6,10,5,0,15
"2293","10350975",0,1,0,0,0,0
"2294","10350999",0,4,1,1,1,3
"2295","10351038",0,5,4,0,0,4
"2296","10351039",0,4,0,1,0,1
"2297","10351101",0,6,3,3,0,6
"2298","10351128",0,4,0,0,0,0
"2299","10351170",0,4,5,1,0,6
"2300","10351217",0,5,0,0,0,0
"2301","10351268",0,4,0,0,0,0
"2302","10351284",0,3,0,0,0,0
"2303","10351306",0,6,6,3,0,9
"2304","10351311",0,4,0,0,0,0
"2305","10351321",0,3,0,1,0,1
"2306","10351331",0,3,2,0,0,2
"2307","10351452",0,3,1,2,0,3
"2308","10351465",0,4,0,0,0,0
"2309","10351592",0,5,6,1,0,7
"2310","10351630",0,6,4,6,2,12
"2311","10351668",0,4,0,2,0,2
"2312","10351712",0,5,7,1,0,8
"2313","10351730",0,4,2,1,0,3
"2314","10351736",0,3,1,0,0,1
"2315","10351783",0,2,0,0,0,0
"2316","10351893",0,4,1,0,0,1
"2317","10351895",0,4,0,0,0,0
"2318","10351903",0,4,5,1,0,6
"2319","10352007",0,5,5,4,1,10
"2320","10352016",0,3,2,3,0,5
"2321","10352051",0,5,13,6,0,19
"2322","10352063",0,4,2,1,0,3
"2323","10352090",0,5,2,3,0,5
"2324","10352140",0,6,12,2,0,14
"2325","10352146",0,6,9,1,0,10
"2326","10352216",0,2,2,0,0,2
"2327","10352246",0,9,14,8,0,22
"2328","10352255",0,3,0,0,0,0
"2329","10352281",0,4,0,1,0,1
"2330","10352327",0,1,0,0,0,0
"2331","10352378",0,3,0,0,0,0
"2332","10352397",0,10,13,13,5,31
"2333","10352403",0,5,4,7,0,11
"2334","10352456",0,7,9,5,0,14
"2335","10352609",0,1,0,0,0,0
"2336","10352635",0,3,4,1,0,5
"2337","10352700",0,7,8,5,1,14
"2338","10352763",0,5,2,2,0,4
"2339","10352846",0,9,19,11,5,35
"2340","10352913",0,2,1,0,0,1
"2341","10353059",0,5,1,0,0,1
"2342","10353150",0,5,0,2,0,2
"2343","10353188",0,1,0,0,0,0
"2344","10353217",0,4,0,1,0,1
"2345","10353253",0,8,16,9,0,25
"2346","10353280",0,4,0,0,0,0
"2347","10353310",0,2,0,0,0,0
"2348","10353316",0,4,2,0,0,2
"2349","10353321",0,2,2,1,0,3
"2350","10353377",1,5,1,2,0,3
"2351","10353425",0,4,6,1,1,8
"2352","10353427",0,1,0,0,0,0
"2353","10353431",0,1,0,0,0,0
"2354","10353435",0,4,2,0,0,2
"2355","10353609",0,6,4,4,2,10
"2356","10353612",0,3,4,0,0,4
"2357","10353706",0,3,0,0,0,0
"2358","10353759",0,1,2,0,0,2
"2359","10353770",0,1,0,0,0,0
"2360","10353884",0,1,1,0,0,1
"2361","10353914",0,4,3,1,0,4
"2362","10353943",0,4,1,0,0,1
"2363","10353975",0,4,5,2,0,7
"2364","10354091",0,6,6,4,0,10
"2365","10354239",0,7,15,5,0,20
"2366","10354263",0,6,7,5,2,14
"2367","10354265",0,2,0,0,0,0
"2368","10354347",0,7,12,4,0,16
"2369","10354372",0,6,6,2,1,9
"2370","10354493",0,3,0,1,0,1
"2371","10354645",0,6,9,5,0,14
"2372","10354647",0,1,0,0,0,0
"2373","10354667",0,3,0,0,0,0
"2374","10354716",0,5,2,0,0,2
"2375","10354718",0,1,1,0,0,1
"2376","10354727",0,1,0,0,0,0
"2377","10354729",0,5,6,2,0,8
"2378","10354782",0,7,11,9,0,20
"2379","10354919",0,7,1,8,1,10
"2380","10354920",0,4,1,1,0,2
"2381","10355002",0,3,0,4,0,4
"2382","10355009",0,1,0,0,0,0
"2383","10355014",0,3,5,0,0,5
"2384","10355086",0,1,0,0,0,0
"2385","10355096",0,1,0,0,0,0
"2386","10355127",0,1,0,0,0,0
"2387","10355253",0,4,0,2,0,2
"2388","10355345",0,7,1,5,0,6
"2389","10355463",0,6,6,1,1,8
"2390","10355484",0,2,1,0,0,1
"2391","10355507",0,4,0,0,0,0
"2392","10355613",0,3,6,6,0,12
"2393","10355660",0,1,0,0,0,0
"2394","10355664",0,1,0,0,0,0
"2395","10355742",0,2,1,1,0,2
"2396","10355769",0,5,7,0,0,7
"2397","10355859",0,3,3,5,1,9
"2398","10355886",0,3,0,0,0,0
"2399","10355925",0,2,1,2,1,4
"2400","10355944",0,4,0,2,0,2
"2401","10356010",0,5,5,1,0,6
"2402","10356054",0,7,7,6,1,14
"2403","10356090",0,7,10,2,0,12
"2404","10356095",0,4,3,2,1,6
"2405","10356126",0,7,3,0,1,4
"2406","10356227",0,4,0,0,0,0
"2407","10356237",0,5,5,1,0,6
"2408","10356239",0,4,0,0,0,0
"2409","10356295",0,5,2,0,0,2
"2410","10356429",0,5,4,2,0,6
"2411","10356561",0,1,0,0,0,0
"2412","10356597",0,8,10,5,1,16
"2413","10356752",0,1,0,0,0,0
"2414","10356803",0,3,0,0,0,0
"2415","10356846",0,1,0,0,0,0
"2416","10356847",0,1,0,0,0,0
"2417","10356863",0,4,5,1,0,6
"2418","10356874",0,6,0,0,0,0
"2419","10356900",0,4,0,1,0,1
"2420","10356997",0,2,1,0,0,1
"2421","10357019",0,4,1,0,0,1
"2422","10357044",0,4,0,1,0,1
"2423","10357058",0,2,3,3,0,6
"2424","10357104",0,5,7,5,1,13
"2425","10357195",0,3,1,0,0,1
"2426","10357203",0,7,2,0,0,2
"2427","10357209",0,8,8,5,0,13
"2428","10357216",0,4,0,0,0,0
"2429","10357234",0,2,2,1,0,3
"2430","10357240",0,4,3,0,0,3
"2431","10357243",0,5,5,1,0,6
"2432","10357247",0,4,1,0,0,1
"2433","10357281",0,3,1,4,0,5
"2434","10357332",0,4,1,1,0,2
"2435","10357373",0,3,1,1,0,2
"2436","10357404",0,3,1,0,0,1
"2437","10357412",0,4,0,0,0,0
"2438","10357429",0,6,1,3,0,4
"2439","10357435",0,3,5,1,0,6
"2440","10357472",0,9,6,9,0,15
"2441","10357522",0,4,0,0,0,0
"2442","10357531",0,4,2,0,0,2
"2443","10357582",0,1,0,0,0,0
"2444","10357617",0,4,2,1,0,3
"2445","10357662",0,1,2,3,0,5
"2446","10357674",0,3,4,0,0,4
"2447","10357683",0,4,0,1,0,1
"2448","10357706",0,6,8,6,0,14
"2449","10357715",0,4,2,1,0,3
"2450","10357717",0,5,7,1,0,8
"2451","10357719",0,2,0,2,0,2
"2452","10357721",0,7,9,2,0,11
"2453","10357723",1,4,3,0,0,3
"2454","10357726",0,4,3,3,1,7
"2455","10357736",0,1,0,0,0,0
"2456","10357756",0,2,3,0,0,3
"2457","10357762",0,1,0,0,0,0
"2458","10357813",0,3,0,0,0,0
"2459","10357814",0,4,8,3,0,11
"2460","10357861",0,4,1,2,0,3
"2461","10357918",0,9,7,8,2,17
"2462","10357941",0,5,3,4,2,9
"2463","10357957",0,6,4,3,0,7
"2464","10357984",0,6,3,2,0,5
"2465","10358166",0,3,1,2,0,3
"2466","10358175",0,1,0,0,0,0
"2467","10358238",0,4,1,7,0,8
"2468","10358321",0,1,0,1,0,1
"2469","10358331",0,1,0,0,0,0
"2470","10358332",0,4,1,0,0,1
"2471","10358498",0,3,0,0,0,0
"2472","10358501",0,2,0,0,0,0
"2473","10358509",0,4,4,0,0,4
"2474","10358588",0,6,4,3,0,7
"2475","10358679",0,3,0,0,0,0
"2476","10358702",0,3,0,2,0,2
"2477","10358744",0,7,17,7,1,25
"2478","10358751",1,5,0,0,0,0
"2479","10358776",0,1,0,0,0,0
"2480","10358777",0,1,0,0,0,0
"2481","10358781",0,1,0,0,0,0
"2482","10358804",0,2,1,2,0,3
"2483","10358808",0,3,0,4,0,4
"2484","10358833",0,2,0,0,0,0
"2485","10358866",0,1,0,0,0,0
"2486","10358892",0,4,3,0,0,3
"2487","10358895",0,1,0,0,0,0
"2488","10358929",0,6,2,2,0,4
"2489","10358983",0,4,7,4,0,11
"2490","10358994",0,3,3,3,0,6
"2491","10359021",0,4,0,0,0,0
"2492","10359062",0,3,7,0,1,8
"2493","10359121",0,4,0,3,0,3
"2494","10359123",0,1,1,0,0,1
"2495","10359185",0,5,5,3,0,8
"2496","10359217",0,5,0,0,0,0
"2497","10359225",0,4,0,0,0,0
"2498","10359266",0,6,5,3,0,8
"2499","10359316",0,4,0,0,0,0
"2500","10359318",0,4,1,0,0,1
"2501","10359338",0,4,5,0,0,5
"2502","10359376",0,4,3,1,0,4
"2503","10359377",0,4,0,1,0,1
"2504","10359388",0,5,1,1,1,3
"2505","10359417",0,1,0,0,0,0
"2506","10359478",0,4,3,3,0,6
"2507","10359550",0,6,0,1,0,1
"2508","10359577",0,3,3,0,0,3
"2509","10359638",0,4,3,3,0,6
"2510","10359654",0,1,0,0,0,0
"2511","10359655",0,2,0,0,0,0
"2512","10359686",0,5,4,9,0,13
"2513","10359713",0,3,3,0,0,3
"2514","10359743",0,4,4,4,0,8
"2515","10359765",0,2,0,0,0,0
"2516","10359780",0,1,0,0,0,0
"2517","10359813",0,4,6,3,0,9
"2518","10359854",0,2,0,0,0,0
"2519","10359930",0,6,7,3,2,12
"2520","10359949",0,3,4,0,0,4
"2521","10360062",0,2,0,1,0,1
"2522","10360093",0,4,2,1,0,3
"2523","10360137",0,1,0,0,0,0
"2524","10360232",0,3,1,3,0,4
"2525","10360314",0,4,3,0,0,3
"2526","10360315",0,4,1,0,0,1
"2527","10360384",0,7,0,0,0,0
"2528","10360413",0,9,7,3,1,11
"2529","10360522",0,6,1,10,0,11
"2530","10360577",0,4,2,0,0,2
"2531","10360593",0,3,0,1,0,1
"2532","10360604",0,1,0,0,0,0
"2533","10360715",0,14,17,14,3,34
"2534","10360736",0,7,14,3,1,18
"2535","10360738",0,1,0,0,0,0
"2536","10360788",1,4,0,0,0,0
"2537","10360850",0,1,0,1,0,1
"2538","10360873",0,2,0,0,0,0
"2539","10360876",0,9,9,8,1,18
"2540","10360893",0,1,0,0,0,0
"2541","10360897",0,4,0,0,0,0
"2542","10360900",0,4,2,1,0,3
"2543","10360906",0,6,7,5,0,12
"2544","10360959",0,1,0,3,0,3
"2545","10360962",0,3,2,0,0,2
"2546","10360978",0,1,0,0,0,0
"2547","10360981",1,4,0,0,0,0
"2548","10361054",0,6,2,4,0,6
"2549","10361064",0,4,0,1,0,1
"2550","10361115",0,2,3,1,0,4
"2551","10361117",0,4,1,3,2,6
"2552","10361138",0,1,0,0,0,0
"2553","10361225",0,4,1,0,0,1
"2554","10361226",0,1,1,0,0,1
"2555","10361295",0,1,0,0,0,0
"2556","10361299",0,3,0,0,0,0
"2557","10361366",0,3,0,0,0,0
"2558","10361391",0,1,0,0,0,0
"2559","10361396",0,3,3,0,0,3
"2560","10361402",0,1,0,0,0,0
"2561","10361427",0,2,0,0,0,0
"2562","10361445",0,4,0,0,0,0
"2563","10361462",0,3,4,3,0,7
"2564","10361478",0,2,3,1,0,4
"2565","10361482",0,4,0,0,0,0
"2566","10361498",0,4,5,5,0,10
"2567","10361542",0,3,3,2,0,5
"2568","10361549",0,1,0,0,0,0
"2569","10361566",0,9,10,10,1,21
"2570","10361610",0,3,1,0,0,1
"2571","10361614",0,2,0,0,0,0
"2572","10361616",0,4,3,0,0,3
"2573","10361620",1,4,2,2,0,4
"2574","10361633",0,2,1,0,0,1
"2575","10361639",0,4,1,0,0,1
"2576","10361647",0,3,1,0,0,1
"2577","10361663",0,4,4,0,0,4
"2578","10361664",0,1,1,0,0,1
"2579","10361667",0,2,0,0,1,1
"2580","10361669",0,4,2,2,2,6
"2581","10361750",0,6,15,16,5,36
"2582","10361914",0,2,0,0,0,0
"2583","10362030",0,1,0,0,0,0
"2584","10362037",0,4,1,2,0,3
"2585","10362056",0,9,12,13,1,26
"2586","10362063",0,3,3,2,1,6
"2587","10362064",0,2,0,0,0,0
"2588","10362152",0,4,1,0,0,1
"2589","10362190",0,4,0,0,0,0
"2590","10362235",0,6,9,3,0,12
"2591","10362297",0,3,1,0,0,1
"2592","10362331",1,1,0,0,0,0
"2593","10362349",0,4,0,4,0,4
"2594","10362375",0,6,9,2,0,11
"2595","10362446",0,3,4,0,0,4
"2596","10362456",0,3,2,2,0,4
"2597","10362463",0,5,10,2,0,12
"2598","10362471",0,1,1,0,0,1
"2599","10362472",0,2,1,1,0,2
"2600","10362480",0,6,3,2,1,6
"2601","10362529",0,5,6,3,0,9
"2602","10362556",0,3,0,1,0,1
"2603","10362565",0,4,4,2,0,6
"2604","10362572",0,5,1,6,0,7
"2605","10362575",0,3,1,1,1,3
"2606","10362576",0,4,2,0,0,2
"2607","10362598",0,4,0,1,0,1
"2608","10362614",0,7,8,6,2,16
"2609","10362672",1,5,0,3,0,3
"2610","10362675",0,5,1,1,0,2
"2611","10362680",0,2,1,1,0,2
"2612","10362681",0,5,7,3,0,10
"2613","10362695",0,2,0,0,0,0
"2614","10362700",0,4,0,0,0,0
"2615","10362706",0,1,0,0,0,0
"2616","10362707",0,4,0,0,0,0
"2617","10362747",0,2,0,1,0,1
"2618","10362755",0,1,0,1,0,1
"2619","10362799",0,2,0,0,0,0
"2620","10362827",0,7,8,3,1,12
"2621","10362858",0,2,0,1,0,1
"2622","10362897",0,1,1,0,0,1
"2623","10362936",0,1,3,0,0,3
"2624","10362974",0,5,7,1,0,8
"2625","10362975",0,3,2,0,0,2
"2626","10363019",0,3,0,0,0,0
"2627","10363022",0,2,2,3,0,5
"2628","10363028",0,1,0,0,0,0
"2629","10363041",0,1,0,0,0,0
"2630","10363112",0,2,0,0,0,0
"2631","10363212",0,3,2,2,0,4
"2632","10363302",0,2,0,0,0,0
"2633","10363314",0,5,3,1,0,4
"2634","10363323",0,5,1,4,0,5
"2635","10363325",0,6,1,2,0,3
"2636","10363328",0,4,0,0,0,0
"2637","10363352",0,3,2,1,0,3
"2638","10363368",0,4,0,0,0,0
"2639","10363564",0,4,2,0,0,2
"2640","10363631",0,5,5,6,0,11
"2641","10363669",0,6,2,4,0,6
"2642","10363687",0,2,0,0,0,0
"2643","10363725",0,8,5,5,1,11
"2644","10363746",0,1,1,1,0,2
"2645","10363762",0,1,0,0,0,0
"2646","10363766",0,5,2,3,0,5
"2647","10363769",0,6,5,9,0,14
"2648","10363818",0,4,1,0,0,1
"2649","10363823",0,5,8,4,0,12
"2650","10363894",0,4,7,1,0,8
"2651","10363895",0,6,14,2,2,18
"2652","10364027",0,3,2,3,0,5
"2653","10364048",0,1,0,0,0,0
"2654","10364325",0,1,0,0,0,0
"2655","10364374",0,5,5,1,0,6
"2656","10364416",0,1,0,0,0,0
"2657","10364417",0,5,2,0,0,2
"2658","10364428",0,1,0,0,0,0
"2659","10364429",0,1,0,0,0,0
"2660","10364477",0,7,8,5,1,14
"2661","10364493",0,1,1,0,0,1
"2662","10364598",1,1,0,0,0,0
"2663","10364705",1,4,1,1,0,2
"2664","10364708",1,4,0,0,0,0
"2665","10364718",0,5,6,3,0,9
"2666","10364753",0,7,8,5,0,13
"2667","10364757",0,6,7,7,0,14
"2668","10364890",0,3,1,1,0,2
"2669","10364892",0,3,2,3,0,5
"2670","10364929",0,4,2,0,0,2
"2671","10364949",0,6,1,4,0,5
"2672","10364965",0,4,4,1,0,5
"2673","10364970",0,5,1,0,0,1
"2674","10364994",0,4,2,0,0,2
"2675","10365004",0,1,1,0,0,1
"2676","10365023",0,5,4,7,0,11
"2677","10365045",1,3,2,0,0,2
"2678","10365046",1,3,0,1,0,1
"2679","10365048",0,5,6,0,0,6
"2680","10365080",1,1,0,0,0,0
"2681","10365139",0,4,3,0,0,3
"2682","10365146",0,3,8,0,0,8
"2683","10365169",0,4,0,2,0,2
"2684","10365252",0,6,3,2,0,5
"2685","10365279",0,1,0,1,0,1
"2686","10365344",0,3,0,0,0,0
"2687","10365390",0,3,5,1,0,6
"2688","10365461",0,4,2,1,0,3
"2689","10365465",0,4,9,0,0,9
"2690","10365468",0,3,0,3,0,3
"2691","10365481",0,3,0,2,1,3
"2692","10365522",0,4,0,0,0,0
"2693","10365550",0,1,0,0,0,0
"2694","10365572",0,2,0,0,0,0
"2695","10365643",0,3,0,1,0,1
"2696","10365662",0,3,4,1,0,5
"2697","10365713",0,2,0,0,0,0
"2698","10365728",0,4,1,0,0,1
"2699","10365811",0,2,0,0,0,0
"2700","10365821",0,4,7,2,0,9
"2701","10365896",1,1,0,0,0,0
"2702","10365900",0,2,0,0,0,0
"2703","10366024",0,11,20,7,5,32
"2704","10366054",0,4,3,0,0,3
"2705","10366062",0,2,0,1,0,1
"2706","10366120",0,4,0,0,0,0
"2707","10366126",0,3,1,0,0,1
"2708","10366138",0,4,1,0,0,1
"2709","10366139",0,11,10,21,4,35
"2710","10366150",0,6,4,4,0,8
"2711","10366171",0,1,0,1,0,1
"2712","10366215",0,4,0,0,0,0
"2713","10366301",0,2,0,0,0,0
"2714","10366330",0,7,7,12,1,20
"2715","10366341",0,1,0,0,0,0
"2716","10366435",0,4,10,4,0,14
"2717","10366596",0,6,1,0,0,1
"2718","10366597",0,4,0,0,0,0
"2719","10366622",0,5,2,6,0,8
"2720","10366623",0,5,3,2,0,5
"2721","10366633",0,6,1,1,0,2
"2722","10366771",0,1,0,0,0,0
"2723","10366803",0,3,0,0,0,0
"2724","10366883",0,7,8,3,0,11
"2725","10366897",0,1,1,0,0,1
"2726","10366919",0,2,0,0,0,0
"2727","10366944",0,3,4,0,0,4
"2728","10366969",0,4,1,1,0,2
"2729","10366978",0,3,9,1,0,10
"2730","10367002",1,2,0,1,1,2
"2731","10367020",1,1,1,0,0,1
"2732","10367046",0,2,1,0,0,1
"2733","10367071",0,5,3,2,1,6
"2734","10367117",0,3,2,1,0,3
"2735","10367133",0,5,4,2,0,6
"2736","10367201",0,4,3,4,0,7
"2737","10367303",0,3,4,1,0,5
"2738","10367337",0,1,0,0,0,0
"2739","10367346",0,5,6,7,1,14
"2740","10367384",0,5,11,2,0,13
"2741","10367474",0,2,0,0,0,0
"2742","10367524",0,3,1,0,0,1
"2743","10367570",0,4,3,1,0,4
"2744","10367591",0,4,6,3,0,9
"2745","10367634",0,12,9,15,1,25
"2746","10367676",0,1,0,0,0,0
"2747","10367710",1,1,0,1,0,1
"2748","10367715",0,5,5,0,0,5
"2749","10367781",0,2,2,0,0,2
"2750","10367895",1,8,0,6,1,7
"2751","10367907",0,4,1,7,0,8
"2752","10367927",0,4,6,0,0,6
"2753","10367931",0,4,4,3,0,7
"2754","10367958",0,2,0,0,0,0
"2755","10368054",0,4,2,0,0,2
"2756","10368071",0,1,0,0,0,0
"2757","10368072",0,6,3,4,1,8
"2758","10368076",0,5,5,2,0,7
"2759","10368116",0,4,3,0,0,3
"2760","10368134",0,6,13,1,0,14
"2761","10368143",0,4,4,2,0,6
"2762","10368194",0,3,10,1,0,11
"2763","10368350",0,3,7,2,0,9
"2764","10368384",0,3,2,0,0,2
"2765","10368398",0,3,0,0,0,0
"2766","10368402",0,5,0,0,0,0
"2767","10368469",0,5,4,2,0,6
"2768","10368495",1,2,0,0,0,0
"2769","10368527",0,4,1,0,0,1
"2770","10368545",0,2,0,0,0,0
"2771","10368632",0,1,0,0,0,0
"2772","10368666",0,1,0,0,0,0
"2773","10368728",0,2,0,2,0,2
"2774","10368809",0,2,0,0,0,0
"2775","10368810",0,3,0,2,1,3
"2776","10368869",0,4,1,0,0,1
"2777","10368965",0,5,6,2,0,8
"2778","10369058",0,1,2,0,0,2
"2779","10369131",0,4,0,0,0,0
"2780","10369184",0,4,3,1,0,4
"2781","10369291",0,3,0,0,0,0
"2782","10369391",0,1,0,2,0,2
"2783","10369511",0,5,2,1,0,3
"2784","10369520",0,3,0,0,0,0
"2785","10369545",0,2,1,1,0,2
"2786","10369568",0,1,2,0,0,2
"2787","10369689",0,3,3,1,0,4
"2788","10369691",0,3,1,0,0,1
"2789","10369731",0,6,3,3,0,6
"2790","10369734",0,6,10,2,0,12
"2791","10369735",0,1,0,0,0,0
"2792","10369823",0,1,1,1,0,2
"2793","10369825",0,4,0,0,0,0
"2794","10369848",0,2,0,0,0,0
"2795","10369850",0,10,8,9,1,18
"2796","10369889",0,3,1,0,0,1
"2797","10369891",0,4,1,1,0,2
"2798","10369896",0,1,0,1,0,1
"2799","10369964",0,1,0,0,0,0
"2800","10370035",0,4,3,5,0,8
"2801","10370044",0,2,0,0,0,0
"2802","10370052",0,4,2,1,0,3
"2803","10370055",0,1,1,0,0,1
"2804","10370066",0,5,1,4,0,5
"2805","10370079",0,6,9,5,0,14
"2806","10370190",0,9,13,4,0,17
"2807","10370323",0,1,0,0,0,0
"2808","10370340",0,8,4,8,1,13
"2809","10370355",0,1,0,0,0,0
"2810","10370387",0,3,3,0,0,3
"2811","10370477",0,8,11,4,0,15
"2812","10370483",0,7,11,7,0,18
"2813","10370514",0,12,16,19,3,38
"2814","10370528",0,3,0,0,0,0
"2815","10370543",0,4,9,9,0,18
"2816","10370566",0,4,0,1,0,1
"2817","10370592",0,5,2,5,0,7
"2818","10370595",0,3,2,5,0,7
"2819","10370672",0,3,2,0,0,2
"2820","10370796",0,2,0,1,0,1
"2821","10370849",0,1,0,0,0,0
"2822","10370864",0,1,0,0,0,0
"2823","10370925",0,5,2,0,0,2
"2824","10370986",0,6,11,5,0,16
"2825","10371006",0,2,0,0,0,0
"2826","10371023",0,1,0,0,0,0
"2827","10371024",0,1,0,0,0,0
"2828","10371045",0,1,0,0,0,0
"2829","10371177",0,3,2,0,0,2
"2830","10371287",0,4,3,2,1,6
"2831","10371313",0,1,0,0,0,0
"2832","10371385",0,10,19,5,1,25
"2833","10371388",0,2,1,3,0,4
"2834","10371441",0,5,12,4,0,16
"2835","10371640",0,4,4,0,0,4
"2836","10371679",0,4,4,4,0,8
"2837","10371707",0,10,13,10,3,26
"2838","10371718",0,3,0,0,0,0
"2839","10371803",0,3,5,1,0,6
"2840","10372018",0,4,0,1,0,1
"2841","10372088",0,7,7,11,0,18
"2842","10372098",0,2,0,0,0,0
"2843","10372133",0,5,2,0,0,2
"2844","10372148",0,5,0,2,0,2
"2845","10372212",0,2,0,0,0,0
"2846","10372222",0,1,1,0,0,1
"2847","10372227",0,4,0,0,0,0
"2848","10372241",0,7,7,3,0,10
"2849","10372406",0,4,6,0,0,6
"2850","10372466",0,4,1,0,0,1
"2851","10372473",0,2,0,0,0,0
"2852","10372481",0,3,2,0,0,2
"2853","10372704",0,2,0,0,0,0
"2854","10372782",0,2,2,2,0,4
"2855","10372854",0,7,4,4,2,10
"2856","10372928",0,1,0,1,0,1
"2857","10372939",0,5,0,5,3,8
"2858","10372979",0,1,1,0,0,1
"2859","10372999",0,5,2,0,0,2
"2860","10373068",0,7,8,8,3,19
"2861","10373198",0,15,8,13,6,27
"2862","10373202",0,3,0,0,0,0
"2863","10373273",0,1,0,0,0,0
"2864","10373342",0,3,3,0,0,3
"2865","10373355",0,7,7,7,0,14
"2866","10373494",0,1,0,0,0,0
"2867","10373576",0,4,2,2,0,4
"2868","10373613",0,1,0,0,0,0
"2869","10373643",0,3,0,0,0,0
"2870","10373760",0,4,7,3,0,10
"2871","10373783",0,4,3,5,1,9
"2872","10373813",0,2,3,1,0,4
"2873","10373883",0,1,0,0,0,0
"2874","10373911",0,4,2,0,0,2
"2875","10373912",0,3,3,2,0,5
"2876","10373914",0,1,0,0,0,0
"2877","10373921",0,7,6,6,2,14
"2878","10373974",0,4,0,3,1,4
"2879","10374170",1,5,0,0,0,0
"2880","10374233",0,2,0,0,0,0
"2881","10374260",0,4,6,3,0,9
"2882","10374385",0,6,9,2,0,11
"2883","10374437",0,2,2,2,0,4
"2884","10374474",0,1,0,0,0,0
"2885","10374521",0,7,3,4,0,7
"2886","10374638",0,5,6,2,0,8
"2887","10374643",0,4,6,2,0,8
"2888","10374687",0,1,0,0,0,0
"2889","10374737",0,8,8,5,1,14
"2890","10374744",0,4,3,6,0,9
"2891","10374747",0,2,0,0,0,0
"2892","10374748",0,4,1,1,0,2
"2893","10374757",0,3,3,2,0,5
"2894","10374758",0,3,0,0,0,0
"2895","10374760",0,6,4,0,0,4
"2896","10374849",0,5,3,2,0,5
"2897","10374896",0,9,2,10,0,12
"2898","10374939",0,1,1,0,0,1
"2899","10374950",0,2,0,0,0,0
"2900","10374974",0,1,0,0,0,0
"2901","10375022",0,6,6,4,0,10
"2902","10375033",0,7,10,5,0,15
"2903","10375189",0,7,4,5,0,9
"2904","10375209",0,6,8,6,3,17
"2905","10375229",0,1,0,0,0,0
"2906","10375553",0,5,2,0,0,2
"2907","10375554",0,7,11,8,2,21
"2908","10375679",0,6,6,5,1,12
"2909","10375789",1,5,1,0,0,1
"2910","10375844",0,4,3,3,0,6
"2911","10375931",0,2,0,0,0,0
"2912","10376240",0,3,2,1,0,3
"2913","10376390",0,3,1,0,0,1
"2914","10376506",0,3,0,0,0,0
"2915","10376557",0,4,3,0,0,3
"2916","10376606",1,5,0,4,0,4
"2917","10376619",0,4,6,1,0,7
"2918","10376655",0,6,5,0,0,5
"2919","10376744",0,9,11,11,4,26
"2920","10376779",0,7,5,5,2,12
"2921","10376926",0,5,10,8,0,18
"2922","10376931",0,5,4,6,0,10
"2923","10376990",0,2,3,0,0,3
"2924","10377106",0,4,0,0,0,0
"2925","10377118",0,4,9,1,0,10
"2926","10377128",0,3,1,1,0,2
"2927","10377131",0,5,5,3,0,8
"2928","10377138",0,3,2,1,0,3
"2929","10377160",0,6,0,0,0,0
"2930","10377227",0,1,0,0,0,0
"2931","10377331",0,4,2,0,0,2
"2932","10377345",0,7,13,6,1,20
"2933","10377352",0,3,0,1,0,1
"2934","10377451",0,4,1,0,0,1
"2935","10377500",0,4,0,0,0,0
"2936","10377526",0,2,3,1,0,4
"2937","10377603",0,5,8,1,0,9
"2938","10377653",0,4,2,2,0,4
"2939","10377656",0,1,0,0,0,0
"2940","10377674",0,2,0,0,0,0
"2941","10377681",0,6,14,3,0,17
"2942","10377717",0,4,2,3,0,5
"2943","10377718",0,1,0,0,0,0
"2944","10377722",0,4,0,1,0,1
"2945","10377725",0,5,1,3,1,5
"2946","10377740",0,3,0,0,0,0
"2947","10377743",0,4,1,1,0,2
"2948","10377822",0,4,1,3,0,4
"2949","10377826",0,4,2,0,0,2
"2950","10377852",0,2,1,0,0,1
"2951","10377890",0,3,1,0,0,1
"2952","10377947",0,6,10,2,0,12
"2953","10377952",0,4,0,0,0,0
"2954","10377958",0,3,4,4,0,8
"2955","10378042",1,5,0,0,0,0
"2956","10378139",0,6,3,4,0,7
"2957","10378143",0,5,4,8,1,13
"2958","10378328",0,3,3,1,0,4
"2959","10378336",0,3,1,0,0,1
"2960","10378428",0,3,1,1,0,2
"2961","10378492",0,9,9,12,0,21
"2962","10378531",0,1,0,0,0,0
"2963","10378542",0,6,7,2,0,9
"2964","10378571",0,4,2,0,0,2
"2965","10378650",0,4,0,1,0,1
"2966","10378674",0,4,0,1,0,1
"2967","10378727",0,2,0,0,0,0
"2968","10378731",0,2,1,0,0,1
"2969","10378745",0,4,2,1,0,3
"2970","10378845",0,3,2,1,0,3
"2971","10378852",1,6,2,1,0,3
"2972","10379016",0,3,4,0,0,4
"2973","10379026",0,5,1,4,0,5
"2974","10379083",0,7,16,1,0,17
"2975","10379153",0,4,1,2,0,3
"2976","10379158",0,4,5,3,0,8
"2977","10379160",0,1,0,1,0,1
"2978","10379166",0,4,4,2,0,6
"2979","10379179",0,1,0,0,0,0
"2980","10379199",0,4,3,3,0,6
"2981","10379233",0,4,0,0,0,0
"2982","10379282",0,7,0,3,0,3
"2983","10379336",0,4,1,0,0,1
"2984","10379376",0,2,2,2,0,4
"2985","10379380",0,7,6,5,0,11
"2986","10379569",0,4,4,2,1,7
"2987","10379610",0,5,10,2,2,14
"2988","10379611",0,3,0,0,0,0
"2989","10379625",0,5,5,1,0,6
"2990","10379636",0,4,1,0,0,1
"2991","10379679",0,1,0,0,0,0
"2992","10379684",0,3,0,4,0,4
"2993","10379700",0,3,0,2,0,2
"2994","10379743",0,3,0,0,0,0
"2995","10379805",0,1,0,0,0,0
"2996","10379832",0,2,2,0,0,2
"2997","10379942",0,4,7,2,0,9
"2998","10379947",0,4,6,1,0,7
"2999","10379998",0,3,1,0,0,1
"3000","10380001",1,2,0,0,0,0
"3001","10380018",0,4,1,0,0,1
"3002","10380034",0,4,4,0,0,4
"3003","10380081",0,4,0,0,0,0
"3004","10380120",0,1,0,0,0,0
"3005","10380146",0,9,8,5,3,16
"3006","10380208",0,4,1,0,0,1
"3007","10380241",0,4,5,0,0,5
"3008","10380252",0,3,0,1,0,1
"3009","10380257",0,6,0,0,0,0
"3010","10380263",0,4,0,0,0,0
"3011","10380275",0,1,0,0,0,0
"3012","10380276",0,4,0,0,0,0
"3013","10380313",0,4,12,2,0,14
"3014","10380322",0,5,1,4,1,6
"3015","10380351",0,7,4,0,0,4
"3016","10380405",0,4,6,1,0,7
"3017","10380505",0,7,4,2,1,7
"3018","10380508",0,1,0,0,0,0
"3019","10380559",0,4,2,0,0,2
"3020","10380612",1,8,17,6,3,26
"3021","10380619",0,4,0,0,0,0
"3022","10380631",0,7,9,8,0,17
"3023","10380639",0,5,1,0,0,1
"3024","10380663",0,4,0,0,0,0
"3025","10380778",0,4,0,1,0,1
"3026","10380872",0,5,0,5,0,5
"3027","10380896",0,5,0,2,0,2
"3028","10380983",0,2,1,2,0,3
"3029","10381022",0,1,0,0,0,0
"3030","10381061",0,3,1,0,0,1
"3031","10381084",0,2,0,0,0,0
"3032","10381087",0,5,7,8,1,16
"3033","10381211",0,1,0,0,0,0
"3034","10381223",0,13,13,19,6,38
"3035","10381232",0,3,0,1,0,1
"3036","10381239",0,4,2,1,0,3
"3037","10381287",0,2,0,0,0,0
"3038","10381315",0,1,0,0,0,0
"3039","10381360",0,4,0,0,0,0
"3040","10381361",0,2,0,0,0,0
"3041","10381363",0,1,0,0,0,0
"3042","10381389",0,4,8,1,0,9
"3043","10381402",0,5,9,3,0,12
"3044","10381436",0,2,0,0,0,0
"3045","10381481",0,8,11,11,1,23
"3046","10381491",0,5,4,1,0,5
"3047","10381711",0,1,0,0,0,0
"3048","10381726",0,2,0,0,0,0
"3049","10381727",0,2,4,1,0,5
"3050","10381786",0,3,1,0,0,1
"3051","10381898",0,3,5,0,0,5
"3052","10381955",0,3,1,1,0,2
"3053","10381959",0,3,0,0,0,0
"3054","10381995",0,1,0,0,0,0
"3055","10382018",0,2,1,3,0,4
"3056","10382026",0,6,7,4,0,11
"3057","10382065",0,1,0,0,0,0
"3058","10382092",0,5,4,0,0,4
"3059","10382167",0,3,0,0,0,0
"3060","10382190",0,6,5,8,1,14
"3061","10382207",0,6,1,0,0,1
"3062","10382213",0,7,2,7,0,9
"3063","10382250",0,4,1,3,0,4
"3064","10382282",0,1,0,0,0,0
"3065","10382295",0,1,0,0,0,0
"3066","10382304",0,3,0,1,0,1
"3067","10382344",0,2,0,0,0,0
"3068","10382345",0,4,1,0,0,1
"3069","10382400",0,2,0,1,0,1
"3070","10382502",0,3,3,0,0,3
"3071","10382524",0,5,2,3,0,5
"3072","10382526",0,1,1,1,0,2
"3073","10382602",0,4,4,6,0,10
"3074","10382808",0,2,0,0,0,0
"3075","10382824",0,4,0,0,0,0
"3076","10382859",0,2,0,0,0,0
"3077","10382863",0,4,8,7,0,15
"3078","10382877",0,1,0,1,0,1
"3079","10382918",0,4,0,2,0,2
"3080","10383036",0,3,1,0,0,1
"3081","10383082",0,1,0,0,0,0
"3082","10383085",0,4,1,0,0,1
"3083","10383089",0,4,0,0,0,0
"3084","10383121",0,4,2,0,0,2
"3085","10383277",0,8,19,14,3,36
"3086","10383353",0,1,0,0,0,0
"3087","10383387",0,3,2,2,0,4
"3088","10383538",0,6,13,6,0,19
"3089","10383545",0,10,8,10,2,20
"3090","10383596",0,7,5,5,1,11
"3091","10383634",0,6,5,2,0,7
"3092","10383670",0,5,0,3,0,3
"3093","10383704",0,8,9,3,0,12
"3094","10383730",0,2,1,0,0,1
"3095","10383838",0,4,11,3,0,14
"3096","10383873",0,6,3,3,0,6
"3097","10383878",0,1,0,0,0,0
"3098","10383883",0,4,2,0,0,2
"3099","10383899",0,4,1,0,0,1
"3100","10383952",0,3,0,0,0,0
"3101","10383958",0,3,1,1,0,2
"3102","10383970",0,4,6,2,0,8
"3103","10383982",0,6,0,6,0,6
"3104","10383994",0,1,0,0,0,0
"3105","10384083",0,2,3,0,0,3
"3106","10384192",0,4,1,0,0,1
"3107","10384194",0,2,4,1,0,5
"3108","10384198",0,4,4,0,0,4
"3109","10384316",0,2,1,0,0,1
"3110","10384341",0,2,0,0,0,0
"3111","10384417",0,2,1,0,0,1
"3112","10384476",0,1,0,0,0,0
"3113","10384493",0,6,1,2,3,6
"3114","10384532",0,2,4,2,0,6
"3115","10384540",0,2,2,4,0,6
"3116","10384612",0,9,7,6,0,13
"3117","10384708",0,5,4,2,0,6
"3118","10384734",0,2,0,1,0,1
"3119","10384872",0,4,0,3,0,3
"3120","10384879",0,6,17,3,0,20
"3121","10384938",0,1,0,0,0,0
"3122","10384957",0,4,5,4,0,9
"3123","10384982",0,6,10,1,0,11
"3124","10385008",0,4,3,1,0,4
"3125","10385018",0,4,4,0,1,5
"3126","10385025",0,4,8,2,0,10
"3127","10385028",0,7,3,8,2,13
"3128","10385037",0,1,0,0,0,0
"3129","10385045",0,3,3,0,0,3
"3130","10385050",0,3,0,0,0,0
"3131","10385053",0,1,0,0,0,0
"3132","10385063",0,4,4,8,0,12
"3133","10385077",0,9,5,7,2,14
"3134","10385124",0,2,2,1,0,3
"3135","10385149",0,2,1,1,0,2
"3136","10385170",1,6,1,2,0,3
"3137","10385183",0,7,4,4,3,11
"3138","10385280",0,3,2,0,0,2
"3139","10385317",0,2,1,0,0,1
"3140","10385335",0,7,9,6,1,16
"3141","10385373",0,5,0,0,0,0
"3142","10385393",0,4,0,2,0,2
"3143","10385409",0,2,6,1,0,7
"3144","10385413",0,1,1,0,0,1
"3145","10385447",0,1,0,0,0,0
"3146","10385464",0,1,0,0,0,0
"3147","10385476",0,4,3,0,0,3
"3148","10385481",0,1,0,0,0,0
"3149","10385489",0,3,0,0,0,0
"3150","10385600",0,1,0,0,0,0
"3151","10385648",1,5,2,1,0,3
"3152","10385738",0,1,2,0,0,2
"3153","10385752",0,1,0,0,0,0
"3154","10385753",0,5,0,0,0,0
"3155","10385786",0,2,1,0,0,1
"3156","10385888",0,12,12,15,0,27
"3157","10385890",0,7,7,3,0,10
"3158","10385891",0,1,1,0,0,1
"3159","10385899",0,4,0,0,0,0
"3160","10385905",0,3,0,0,0,0
"3161","10385938",0,3,3,1,0,4
"3162","10386052",0,1,0,0,0,0
"3163","10386063",0,1,0,0,0,0
"3164","10386112",0,4,2,1,0,3
"3165","10386302",0,2,0,0,0,0
"3166","10386323",0,4,5,0,0,5
"3167","10386366",1,6,1,1,0,2
"3168","10386376",0,1,0,0,0,0
"3169","10386463",0,4,1,0,0,1
"3170","10386508",0,4,4,1,0,5
"3171","10386510",0,5,2,0,0,2
"3172","10386531",0,2,0,0,0,0
"3173","10386640",0,8,10,4,0,14
"3174","10386659",0,4,2,0,0,2
"3175","10386703",0,5,4,2,0,6
"3176","10386704",0,4,0,0,0,0
"3177","10386776",0,7,2,4,1,7
"3178","10386789",0,3,0,0,0,0
"3179","10386836",0,4,0,0,0,0
"3180","10386839",0,1,0,4,0,4
"3181","10386869",0,1,0,0,0,0
"3182","10386934",0,3,4,2,0,6
"3183","10386948",0,5,0,0,0,0
"3184","10386983",0,4,0,0,0,0
"3185","10386995",0,3,2,0,1,3
"3186","10387002",0,5,5,9,0,14
"3187","10387028",0,3,0,0,0,0
"3188","10387029",0,3,3,3,0,6
"3189","10387054",0,5,3,0,0,3
"3190","10387069",0,3,7,0,0,7
"3191","10387074",0,4,2,0,0,2
"3192","10387075",0,5,4,1,0,5
"3193","10387082",0,2,3,2,0,5
"3194","10387119",0,1,0,0,0,0
"3195","10387137",0,3,6,1,0,7
"3196","10387139",0,6,5,3,0,8
"3197","10387207",0,5,4,2,0,6
"3198","10387218",0,1,0,0,0,0
"3199","10387238",0,1,1,0,0,1
"3200","10387323",0,3,0,1,0,1
"3201","10387327",0,5,0,3,0,3
"3202","10387355",0,2,1,0,0,1
"3203","10387374",0,8,6,2,0,8
"3204","10387400",0,2,2,1,0,3
"3205","10387410",0,6,1,4,2,7
"3206","10387411",0,2,0,0,0,0
"3207","10387441",0,7,1,1,1,3
"3208","10387498",0,7,4,3,0,7
"3209","10387590",0,4,0,0,0,0
"3210","10387622",0,6,8,4,0,12
"3211","10387677",0,4,0,0,0,0
"3212","10387695",0,6,0,0,0,0
"3213","10387710",0,4,4,0,0,4
"3214","10387715",0,6,5,0,0,5
"3215","10387730",0,6,5,1,0,6
"3216","10387732",0,3,2,2,0,4
"3217","10387740",0,3,3,1,0,4
"3218","10387841",0,1,0,0,0,0
"3219","10387864",0,5,0,1,0,1
"3220","10387910",0,4,0,1,0,1
"3221","10387913",0,1,0,0,0,0
"3222","10388078",0,2,1,0,0,1
"3223","10388128",0,4,0,0,0,0
"3224","10388151",0,4,0,0,0,0
"3225","10388205",0,4,5,3,0,8
"3226","10388206",0,2,0,2,0,2
"3227","10388217",0,4,0,0,0,0
"3228","10388251",0,2,0,0,0,0
"3229","10388252",0,4,0,0,0,0
"3230","10388253",0,2,0,0,0,0
"3231","10388262",0,4,1,1,0,2
"3232","10388300",0,1,1,0,0,1
"3233","10388332",0,5,1,0,0,1
"3234","10388336",0,5,2,0,0,2
"3235","10388345",0,1,1,0,0,1
"3236","10388347",0,4,7,4,0,11
"3237","10388464",0,6,6,2,0,8
"3238","10388534",0,3,1,0,0,1
"3239","10388561",0,5,2,3,0,5
"3240","10388582",0,5,3,5,0,8
"3241","10388615",0,2,3,3,0,6
"3242","10388616",0,1,0,0,0,0
"3243","10388620",0,6,4,1,0,5
"3244","10388647",0,5,0,3,0,3
"3245","10388660",0,3,0,0,0,0
"3246","10388701",0,2,0,1,0,1
"3247","10388743",0,4,1,3,0,4
"3248","10388774",0,5,2,2,0,4
"3249","10388897",0,1,0,0,0,0
"3250","10388906",0,4,0,0,0,0
"3251","10388935",0,3,5,1,0,6
"3252","10388999",0,4,1,1,0,2
"3253","10389054",0,6,0,0,0,0
"3254","10389073",0,1,0,0,0,0
"3255","10389095",0,2,0,0,0,0
"3256","10389126",0,2,0,0,0,0
"3257","10389131",0,8,6,6,1,13
"3258","10389148",0,1,1,1,0,2
"3259","10389193",0,1,0,1,0,1
"3260","10389199",0,6,5,10,1,16
"3261","10389205",0,3,3,2,0,5
"3262","10389236",0,2,0,0,0,0
"3263","10389308",0,3,0,1,0,1
"3264","10389310",0,3,0,0,0,0
"3265","10389314",0,3,2,1,0,3
"3266","10389315",0,1,0,0,0,0
"3267","10389316",0,1,0,0,0,0
"3268","10389320",0,4,0,0,0,0
"3269","10389321",0,4,2,0,0,2
"3270","10389326",0,3,0,1,0,1
"3271","10389327",0,2,0,0,0,0
"3272","10389333",0,7,2,1,0,3
"3273","10389334",0,4,0,0,0,0
"3274","10389345",0,5,1,0,0,1
"3275","10389347",0,1,0,0,0,0
"3276","10389348",0,3,0,0,0,0
"3277","10389349",0,1,0,0,0,0
"3278","10389350",0,3,1,0,0,1
"3279","10389357",0,4,0,0,0,0
"3280","10389364",0,4,1,0,0,1
"3281","10389517",0,6,3,2,0,5
"3282","10389605",0,4,3,1,0,4
"3283","10389634",0,5,6,1,0,7
"3284","10389705",0,2,1,0,0,1
"3285","10389729",0,2,2,0,0,2
"3286","10389752",1,4,0,0,0,0
"3287","10389753",1,6,0,0,0,0
"3288","10389757",1,6,0,0,0,0
"3289","10389758",1,4,0,0,0,0
"3290","10389777",0,5,2,2,0,4
"3291","10389783",0,4,1,1,0,2
"3292","10390045",1,8,3,3,0,6
"3293","10390048",1,4,0,0,0,0
"3294","10390055",0,3,1,1,0,2
"3295","10390087",0,9,9,9,3,21
"3296","10390201",0,4,6,2,0,8
"3297","10390236",0,1,0,0,0,0
"3298","10390305",0,7,5,2,0,7
"3299","10390354",0,2,0,0,0,0
"3300","10390377",0,1,1,0,0,1
"3301","10390381",0,4,0,2,0,2
"3302","10390386",0,3,4,2,0,6
"3303","10390387",0,3,3,1,0,4
"3304","10390400",0,6,3,7,0,10
"3305","10390430",0,6,1,2,1,4
"3306","10390479",0,7,2,3,0,5
"3307","10390487",0,4,4,2,0,6
"3308","10390522",0,4,1,0,0,1
"3309","10390619",0,3,1,0,0,1
"3310","10390622",0,1,1,0,0,1
"3311","10390638",0,8,10,3,1,14
"3312","10390651",0,2,0,0,0,0
"3313","10390692",0,2,1,0,0,1
"3314","10390731",0,1,1,0,0,1
"3315","10390772",0,2,0,2,0,2
"3316","10390838",0,2,0,0,0,0
"3317","10390847",1,5,0,2,0,2
"3318","10390860",0,3,2,2,0,4
"3319","10390867",0,4,1,0,2,3
"3320","10390870",0,8,5,8,1,14
"3321","10390877",0,1,2,0,0,2
"3322","10390928",0,5,0,0,0,0
"3323","10390980",0,5,3,4,0,7
"3324","10391028",0,3,0,1,0,1
"3325","10391029",0,4,2,1,0,3
"3326","10391090",0,3,2,0,0,2
"3327","10391114",0,1,0,0,0,0
"3328","10391163",0,2,0,0,0,0
"3329","10391196",0,4,0,0,0,0
"3330","10391207",0,6,11,7,2,20
"3331","10391288",0,7,4,1,0,5
"3332","10391301",0,2,0,0,0,0
"3333","10391330",0,4,0,0,0,0
"3334","10391353",0,5,7,5,0,12
"3335","10391371",0,2,0,0,0,0
"3336","10391378",0,1,0,0,0,0
"3337","10391514",0,2,0,0,0,0
"3338","10391515",0,1,0,0,0,0
"3339","10391541",0,2,0,0,0,0
"3340","10391580",0,4,3,1,0,4
"3341","10391617",0,4,4,1,0,5
"3342","10391621",0,7,5,5,0,10
"3343","10391852",1,4,0,1,0,1
"3344","10391917",0,6,9,3,0,12
"3345","10391950",0,6,7,0,0,7
"3346","10392009",0,4,0,0,0,0
"3347","10392013",0,5,0,0,0,0
"3348","10392113",0,7,8,11,0,19
"3349","10392177",0,2,0,0,0,0
"3350","10392199",0,4,3,2,0,5
"3351","10392213",0,4,9,2,0,11
"3352","10392233",0,6,3,3,2,8
"3353","10392243",0,1,0,0,0,0
"3354","10392253",0,6,6,9,0,15
"3355","10392266",0,4,0,1,0,1
"3356","10392272",0,1,1,0,0,1
"3357","10392312",0,1,0,0,0,0
"3358","10392380",0,1,0,0,0,0
"3359","10392396",0,2,0,0,0,0
"3360","10392397",0,5,7,3,0,10
"3361","10392400",0,6,4,3,0,7
"3362","10392506",0,2,3,0,0,3
"3363","10392562",0,2,0,3,0,3
"3364","10392597",0,3,0,0,0,0
"3365","10392628",0,3,1,0,0,1
"3366","10392658",0,3,3,0,0,3
"3367","10392664",0,7,6,1,0,7
"3368","10392702",0,1,0,0,0,0
"3369","10392753",0,4,5,5,0,10
"3370","10392773",0,4,0,0,0,0
"3371","10392851",0,1,0,0,0,0
"3372","10392886",0,7,10,6,1,17
"3373","10392905",0,4,1,0,0,1
"3374","10392922",0,5,5,0,0,5
"3375","10393176",0,6,0,0,0,0
"3376","10393177",0,5,7,0,0,7
"3377","10393178",0,4,0,0,0,0
"3378","10393226",0,5,1,0,1,2
"3379","10393285",0,4,3,2,0,5
"3380","10393347",0,3,3,1,0,4
"3381","10393379",0,6,3,1,0,4
"3382","10393416",0,2,0,0,0,0
"3383","10393496",0,5,3,8,0,11
"3384","10393513",0,7,1,4,0,5
"3385","10393589",0,5,1,1,0,2
"3386","10393634",0,2,0,1,0,1
"3387","10393637",0,2,0,0,0,0
"3388","10393659",0,3,0,0,0,0
"3389","10393702",0,1,0,0,0,0
"3390","10393707",0,4,0,0,0,0
"3391","10393718",0,5,5,5,0,10
"3392","10393732",0,6,8,6,0,14
"3393","10393787",0,4,2,0,0,2
"3394","10393805",0,4,1,1,0,2
"3395","10393834",0,4,1,0,0,1
"3396","10393868",0,4,5,2,0,7
"3397","10394014",0,4,0,3,0,3
"3398","10394040",0,4,0,0,0,0
"3399","10394045",0,5,2,2,0,4
"3400","10394087",0,4,0,0,0,0
"3401","10394104",0,6,9,1,0,10
"3402","10394130",0,2,1,1,0,2
"3403","10394131",0,1,1,1,0,2
"3404","10394156",0,5,8,4,0,12
"3405","10394168",0,6,1,4,0,5
"3406","10394196",1,3,0,0,0,0
"3407","10394197",0,1,0,0,0,0
"3408","10394199",0,5,2,0,0,2
"3409","10394269",0,2,0,0,0,0
"3410","10394277",0,3,0,0,0,0
"3411","10394282",0,2,0,2,0,2
"3412","10394285",0,4,2,1,0,3
"3413","10394300",0,3,0,2,0,2
"3414","10394302",0,4,1,2,0,3
"3415","10394323",0,3,0,0,0,0
"3416","10394325",0,4,0,0,0,0
"3417","10394332",0,2,1,0,0,1
"3418","10394390",0,2,4,2,0,6
"3419","10394410",1,4,0,1,0,1
"3420","10394412",0,4,0,3,0,3
"3421","10394445",0,1,0,0,0,0
"3422","10394463",0,6,5,2,0,7
"3423","10394468",0,2,0,0,0,0
"3424","10394473",0,4,1,1,0,2
"3425","10394486",0,2,3,2,0,5
"3426","10394630",0,4,2,0,0,2
"3427","10394640",0,1,0,0,0,0
"3428","10394906",0,5,2,3,0,5
"3429","10394942",0,5,2,1,0,3
"3430","10395012",0,3,5,3,0,8
"3431","10395218",0,7,5,7,0,12
"3432","10395271",0,2,1,0,0,1
"3433","10395297",0,4,0,0,0,0
"3434","10395304",0,3,1,0,0,1
"3435","10395307",0,1,0,0,0,0
"3436","10395312",0,3,2,0,0,2
"3437","10395462",0,4,5,5,1,11
"3438","10395464",0,7,6,4,0,10
"3439","10395466",0,2,0,0,0,0
"3440","10395477",0,6,0,0,0,0
"3441","10395480",0,6,16,4,0,20
"3442","10395541",0,1,0,0,0,0
"3443","10395543",0,4,0,0,0,0
"3444","10395623",0,6,9,2,0,11
"3445","10395625",0,6,7,2,0,9
"3446","10395662",0,3,1,1,0,2
"3447","10395799",0,3,2,4,1,7
"3448","10396004",1,1,0,0,0,0
"3449","10396018",0,5,1,0,0,1
"3450","10396029",0,3,1,0,0,1
"3451","10396171",0,4,3,0,0,3
"3452","10396199",0,4,5,0,0,5
"3453","10396281",0,7,3,6,0,9
"3454","10396283",0,2,0,0,0,0
"3455","10396292",0,6,6,4,0,10
"3456","10396293",0,6,15,5,0,20
"3457","10396300",0,4,2,0,0,2
"3458","10396342",0,4,5,3,0,8
"3459","10396546",0,3,2,1,0,3
"3460","10396573",0,5,5,2,0,7
"3461","10396589",0,6,0,0,0,0
"3462","10396621",0,1,1,0,0,1
"3463","10396640",0,5,9,1,0,10
"3464","10396646",0,6,6,5,0,11
"3465","10396654",0,1,0,0,0,0
"3466","10396710",0,3,0,0,0,0
"3467","10396738",0,2,2,1,1,4
"3468","10396748",0,7,10,4,0,14
"3469","10396795",0,4,1,0,0,1
"3470","10396853",0,7,1,3,0,4
"3471","10396973",0,1,0,0,0,0
"3472","10396998",0,1,0,0,0,0
"3473","10397002",0,6,1,5,0,6
"3474","10397004",0,10,13,10,0,23
"3475","10397059",0,5,5,3,0,8
"3476","10397066",0,5,6,0,0,6
"3477","10397084",0,6,3,4,0,7
"3478","10397184",0,2,3,0,0,3
"3479","10397288",0,4,3,2,1,6
"3480","10397289",0,4,3,3,0,6
"3481","10397290",0,5,3,0,0,3
"3482","10397291",0,1,0,0,0,0
"3483","10397297",0,5,5,3,0,8
"3484","10397305",0,6,7,4,0,11
"3485","10397328",0,1,0,0,0,0
"3486","10397347",0,5,1,1,0,2
"3487","10397361",0,4,5,3,1,9
"3488","10397418",0,2,1,1,0,2
"3489","10397421",0,2,0,2,0,2
"3490","10397426",0,3,0,0,0,0
"3491","10397437",0,5,1,1,0,2
"3492","10397447",0,2,0,0,0,0
"3493","10397450",0,2,5,0,0,5
"3494","10397497",0,2,0,0,0,0
"3495","10397526",0,4,0,0,0,0
"3496","10397544",0,2,1,0,0,1
"3497","10397615",0,1,0,0,0,0
"3498","10397713",0,6,5,2,0,7
"3499","10397721",0,3,1,2,0,3
"3500","10397807",0,4,0,0,0,0
"3501","10397824",0,5,0,0,0,0
"3502","10397849",0,5,10,2,0,12
"3503","10397899",0,4,0,0,0,0
"3504","10397926",0,1,0,0,0,0
"3505","10398038",0,9,8,12,3,23
"3506","10398048",0,2,0,0,0,0
"3507","10398058",0,3,0,0,0,0
"3508","10398118",0,2,0,0,0,0
"3509","10398133",0,5,0,0,0,0
"3510","10398144",0,7,6,3,1,10
"3511","10398150",0,4,4,0,0,4
"3512","10398152",0,4,0,0,0,0
"3513","10398226",0,5,0,0,0,0
"3514","10398340",0,7,7,9,4,20
"3515","10398343",0,6,8,3,0,11
"3516","10398386",0,2,0,0,0,0
"3517","10398425",0,12,16,12,2,30
"3518","10398435",0,2,0,0,0,0
"3519","10398512",0,1,0,0,0,0
"3520","10398520",0,2,0,0,0,0
"3521","10398536",0,7,7,1,0,8
"3522","10398539",0,1,2,0,0,2
"3523","10398543",0,7,3,2,1,6
"3524","10398570",0,3,2,0,0,2
"3525","10398577",0,6,2,0,0,2
"3526","10398598",0,3,1,1,0,2
"3527","10398644",0,3,0,0,0,0
"3528","10398699",0,2,2,0,0,2
"3529","10398776",0,4,8,1,0,9
"3530","10398794",0,5,7,3,0,10
"3531","10398803",0,5,2,0,0,2
"3532","10398904",0,6,6,4,0,10
"3533","10398913",0,1,0,0,0,0
"3534","10398916",0,2,2,0,0,2
"3535","10398957",0,10,16,13,4,33
"3536","10398984",0,3,1,0,0,1
"3537","10399045",0,4,4,2,0,6
"3538","10399061",0,6,9,3,0,12
"3539","10399076",0,4,3,3,0,6
"3540","10399093",0,5,3,5,0,8
"3541","10399102",0,5,5,2,0,7
"3542","10399319",0,3,2,3,0,5
"3543","10399415",0,5,10,3,0,13
"3544","10399416",0,6,6,3,0,9
"3545","10399435",0,3,1,0,0,1
"3546","10399473",0,2,0,0,0,0
"3547","10399492",0,2,0,0,0,0
"3548","10399504",0,2,0,1,0,1
"3549","10399506",0,6,5,6,1,12
"3550","10399519",0,1,0,0,0,0
"3551","10399527",0,13,19,28,3,50
"3552","10399572",0,1,0,0,0,0
"3553","10399589",0,4,0,0,0,0
"3554","10399615",0,4,3,7,0,10
"3555","10399667",0,5,6,2,0,8
"3556","10399693",0,2,1,0,0,1
"3557","10399733",0,5,6,1,0,7
"3558","10399739",0,3,1,0,0,1
"3559","10399741",0,5,3,9,0,12
"3560","10399745",0,1,3,0,0,3
"3561","10399765",0,3,0,0,0,0
"3562","10399804",0,2,5,1,0,6
"3563","10399900",0,4,0,0,0,0
"3564","10399927",0,4,1,2,0,3
"3565","10400114",0,5,4,1,0,5
"3566","10400266",0,6,3,5,0,8
"3567","10400400",0,4,0,0,0,0
"3568","10400502",0,2,0,0,0,0
"3569","10400510",0,3,1,1,0,2
"3570","10400583",0,4,0,2,0,2
"3571","10400585",0,6,0,0,0,0
"3572","10400609",0,8,0,5,1,6
"3573","10400612",0,7,2,9,3,14
"3574","10400616",0,4,0,0,0,0
"3575","10400622",0,6,6,3,0,9
"3576","10400676",0,6,7,4,1,12
"3577","10400679",0,2,0,0,0,0
"3578","10400719",0,5,2,1,0,3
"3579","10400723",0,6,0,0,0,0
"3580","10400787",0,6,3,0,0,3
"3581","10400921",0,6,6,5,0,11
"3582","10401013",0,4,0,0,0,0
"3583","10401064",0,1,0,0,0,0
"3584","10401094",0,4,3,0,0,3
"3585","10401186",0,3,8,3,0,11
"3586","10401366",0,5,4,1,0,5
"3587","10401368",0,6,3,0,0,3
"3588","10401398",0,1,0,0,0,0
"3589","10401494",0,4,2,4,0,6
"3590","10401500",0,3,4,1,0,5
"3591","10401582",0,3,0,0,0,0
"3592","10401641",0,1,0,0,0,0
"3593","10401642",0,1,0,0,0,0
"3594","10401736",0,5,6,4,0,10
"3595","10401738",0,4,0,2,0,2
"3596","10401784",0,3,0,0,0,0
"3597","10401796",0,3,1,1,0,2
"3598","10401837",0,1,0,0,0,0
"3599","10401840",0,1,0,0,0,0
"3600","10401968",0,3,0,3,0,3
"3601","10401988",0,2,3,0,0,3
"3602","10402036",0,5,9,2,0,11
"3603","10402151",0,4,2,2,0,4
"3604","10402199",0,4,2,2,0,4
"3605","10402219",0,6,2,3,0,5
"3606","10402222",0,4,0,1,0,1
"3607","10402248",0,2,0,0,0,0
"3608","10402274",0,3,5,6,1,12
"3609","10402481",0,9,12,6,0,18
"3610","10402484",0,4,0,3,0,3
"3611","10402587",0,1,0,0,0,0
"3612","10402620",0,2,0,0,0,0
"3613","10402638",0,6,4,2,0,6
"3614","10402662",0,5,5,2,0,7
"3615","10402687",0,3,0,1,0,1
"3616","10402691",0,2,0,0,0,0
"3617","10402714",0,5,7,3,0,10
"3618","10402744",0,7,3,3,2,8
"3619","10402747",0,2,0,1,0,1
"3620","10402850",0,5,5,7,0,12
"3621","10402901",0,3,3,0,0,3
"3622","10402910",0,3,1,0,0,1
"3623","10402943",0,2,2,1,0,3
"3624","10402945",0,5,2,0,0,2
"3625","10403022",0,3,0,0,0,0
"3626","10403128",0,2,0,1,0,1
"3627","10403163",0,12,15,11,0,26
"3628","10403292",0,3,0,0,0,0
"3629","10403322",0,2,0,0,0,0
"3630","10403330",0,1,0,0,0,0
"3631","10403376",0,1,0,0,0,0
"3632","10403379",0,4,1,0,0,1
"3633","10403383",0,3,0,0,0,0
"3634","10403390",0,2,0,0,0,0
"3635","10403429",0,3,0,0,0,0
"3636","10403532",0,4,0,0,0,0
"3637","10403548",0,5,1,6,2,9
"3638","10403582",0,4,5,0,0,5
"3639","10403679",0,3,0,0,0,0
"3640","10403692",0,8,9,13,2,24
"3641","10403721",0,2,0,0,0,0
"3642","10403838",0,3,0,0,0,0
"3643","10403872",0,5,0,3,0,3
"3644","10403977",0,4,1,0,0,1
"3645","10403979",0,4,0,8,3,11
"3646","10403999",0,6,2,1,0,3
"3647","10404251",0,4,1,0,0,1
"3648","10404272",0,6,9,2,0,11
"3649","10404315",0,2,2,4,0,6
"3650","10404322",0,3,4,1,0,5
"3651","10404378",0,3,1,2,0,3
"3652","10404439",0,5,5,1,0,6
"3653","10404563",0,4,6,4,0,10
"3654","10404747",0,3,8,2,0,10
"3655","10404785",0,2,0,1,0,1
"3656","10404804",0,5,2,0,0,2
"3657","10404819",0,4,1,1,0,2
"3658","10404875",0,2,0,0,0,0
"3659","10404876",0,4,4,2,0,6
"3660","10404940",0,5,1,3,0,4
"3661","10404950",0,1,0,0,0,0
"3662","10404958",0,8,5,11,1,17
"3663","10404987",0,1,0,0,0,0
"3664","10405139",0,3,6,2,0,8
"3665","10405160",0,2,1,0,0,1
"3666","10405230",0,3,0,0,0,0
"3667","10405237",0,4,0,0,0,0
"3668","10405273",0,1,0,0,0,0
"3669","10405293",0,4,3,2,1,6
"3670","10405319",1,6,2,6,0,8
"3671","10405325",0,11,16,14,1,31
"3672","10405356",0,4,3,0,0,3
"3673","10405368",0,1,0,0,0,0
"3674","10405396",1,4,0,0,0,0
"3675","10405466",0,3,1,0,0,1
"3676","10405486",0,7,2,3,0,5
"3677","10405501",0,3,0,0,0,0
"3678","10405504",0,4,1,3,0,4
"3679","10405626",0,3,0,0,0,0
"3680","10405628",0,4,0,0,0,0
"3681","10405633",0,3,0,0,0,0
"3682","10405638",0,1,0,0,0,0
"3683","10405652",0,4,3,1,0,4
"3684","10405711",0,1,0,0,0,0
"3685","10405812",0,3,0,0,0,0
"3686","10405902",0,4,0,0,0,0
"3687","10405974",0,3,0,0,0,0
"3688","10406030",0,6,8,1,0,9
"3689","10406126",0,4,1,1,0,2
"3690","10406130",0,2,0,0,0,0
"3691","10406132",0,4,0,0,0,0
"3692","10406133",0,4,2,2,0,4
"3693","10406179",0,5,11,3,0,14
"3694","10406269",0,2,0,0,0,0
"3695","10406270",0,6,3,1,0,4
"3696","10406530",0,3,4,0,0,4
"3697","10406540",0,6,10,2,0,12
"3698","10406572",0,3,0,0,0,0
"3699","10406626",0,2,0,0,1,1
"3700","10406638",0,4,0,0,0,0
"3701","10406689",0,4,2,0,0,2
"3702","10406750",1,4,0,1,0,1
"3703","10406753",0,6,3,1,0,4
"3704","10406771",0,4,2,0,0,2
"3705","10406877",0,3,9,1,0,10
"3706","10406893",0,2,4,0,0,4
"3707","10406924",0,5,0,2,0,2
"3708","10406996",0,10,20,9,3,32
"3709","10407032",0,1,0,0,0,0
"3710","10407151",0,6,4,2,0,6
"3711","10407155",0,4,2,0,0,2
"3712","10407223",0,5,0,0,0,0
"3713","10407246",0,7,9,3,0,12
"3714","10407247",0,5,9,2,0,11
"3715","10407251",0,4,2,2,0,4
"3716","10407279",0,4,3,0,0,3
"3717","10407353",0,1,0,0,0,0
"3718","10407403",0,9,6,6,0,12
"3719","10407528",0,1,0,0,0,0
"3720","10407652",0,4,0,0,0,0
"3721","10407723",0,2,1,1,0,2
"3722","10407810",0,6,5,0,0,5
"3723","10407812",0,4,2,1,0,3
"3724","10407849",0,4,1,2,0,3
"3725","10407874",0,1,0,0,0,0
"3726","10407878",0,4,2,4,1,7
"3727","10407903",1,6,1,0,0,1
"3728","10408296",0,4,1,0,0,1
"3729","10408475",0,3,0,0,0,0
"3730","10408512",0,5,0,2,0,2
"3731","10408528",0,5,5,1,0,6
"3732","10408532",0,4,9,2,0,11
"3733","10408619",0,11,9,14,2,25
"3734","10408627",0,4,1,0,0,1
"3735","10408710",0,6,5,2,2,9
"3736","10408713",0,4,0,0,0,0
"3737","10408714",0,4,2,3,0,5
"3738","10408717",0,3,2,0,0,2
"3739","10408718",0,1,0,0,0,0
"3740","10408719",0,1,0,0,0,0
"3741","10408723",0,2,1,0,0,1
"3742","10408765",0,4,0,0,0,0
"3743","10409075",0,1,1,3,0,4
"3744","10409087",0,6,6,4,0,10
"3745","10409158",0,5,7,3,0,10
"3746","10409255",0,6,9,1,0,10
"3747","10409278",0,5,4,2,0,6
"3748","10409285",0,6,1,0,0,1
"3749","10409386",0,2,0,0,0,0
"3750","10409387",0,3,2,0,0,2
"3751","10409433",0,4,2,0,0,2
"3752","10409460",0,2,0,0,0,0
"3753","10409561",0,6,3,4,1,8
"3754","10409628",0,6,0,0,0,0
"3755","10409689",0,8,10,14,3,27
"3756","10409714",0,7,3,0,0,3
"3757","10409731",0,5,4,2,0,6
"3758","10410068",0,5,6,4,2,12
"3759","10410069",0,5,3,2,0,5
"3760","10410092",0,4,0,0,0,0
"3761","10410093",0,1,0,0,0,0
"3762","10410094",0,2,0,0,0,0
"3763","10410176",0,6,1,1,0,2
"3764","10410190",0,4,3,1,0,4
"3765","10410295",0,5,6,3,0,9
"3766","10410341",0,5,1,1,1,3
"3767","10410342",0,4,2,0,0,2
"3768","10410353",0,6,8,5,0,13
"3769","10410371",0,2,2,0,0,2
"3770","10410374",0,2,0,0,0,0
"3771","10410376",0,3,0,0,0,0
"3772","10410505",0,5,11,4,0,15
"3773","10410597",0,6,3,6,1,10
"3774","10410607",0,6,7,1,0,8
"3775","10410608",1,6,3,6,1,10
"3776","10410616",0,1,0,0,0,0
"3777","10410630",0,10,8,5,2,15
"3778","10410649",0,5,8,0,0,8
"3779","10410662",0,5,1,1,0,2
"3780","10410664",0,5,1,0,0,1
"3781","10410665",0,5,2,0,0,2
"3782","10410746",0,5,4,2,0,6
"3783","10410852",0,2,0,0,0,0
"3784","10410856",0,1,0,0,0,0
"3785","10410860",0,4,1,0,0,1
"3786","10410861",0,5,11,6,1,18
"3787","10410875",0,5,4,7,0,11
"3788","10410985",0,3,0,0,0,0
"3789","10410986",0,4,0,1,0,1
"3790","10411003",0,5,5,7,4,16
"3791","10411080",0,4,0,2,0,2
"3792","10411081",0,4,3,1,0,4
"3793","10411118",0,4,10,6,1,17
"3794","10411214",0,4,1,0,0,1
"3795","10411248",0,4,0,1,0,1
"3796","10411251",0,1,0,0,0,0
"3797","10411252",0,7,5,2,0,7
"3798","10411274",0,1,1,0,0,1
"3799","10411305",0,4,5,1,0,6
"3800","10411329",0,1,0,1,0,1
"3801","10411330",0,3,0,0,0,0
"3802","10411339",0,6,3,3,0,6
"3803","10411414",0,4,2,2,0,4
"3804","10411465",0,3,5,2,0,7
"3805","10411486",1,4,1,0,0,1
"3806","10411514",0,4,1,0,0,1
"3807","10411516",0,4,0,5,0,5
"3808","10411606",0,7,10,4,0,14
"3809","10411621",0,8,7,8,4,19
"3810","10411631",0,2,0,0,0,0
"3811","10411632",0,1,0,0,0,0
"3812","10411666",0,5,0,0,0,0
"3813","10411697",0,5,3,0,0,3
"3814","10411724",0,6,10,1,0,11
"3815","10411748",0,1,0,0,0,0
"3816","10411778",0,1,0,0,0,0
"3817","10411840",0,4,1,2,0,3
"3818","10411848",0,6,6,7,2,15
"3819","10411852",0,5,3,1,0,4
"3820","10411856",0,7,0,7,0,7
"3821","10411874",0,7,8,1,1,10
"3822","10411887",0,7,2,7,0,9
"3823","10411895",0,7,8,5,1,14
"3824","10411896",0,9,5,8,2,15
"3825","10411965",0,2,1,0,0,1
"3826","10411971",1,4,3,2,0,5
"3827","10411995",0,4,3,0,0,3
"3828","10412054",0,5,4,10,2,16
"3829","10412080",0,6,4,4,0,8
"3830","10412094",0,1,1,0,0,1
"3831","10412121",0,8,9,5,0,14
"3832","10412135",0,4,0,0,0,0
"3833","10412200",0,7,5,5,0,10
"3834","10412204",0,4,1,1,0,2
"3835","10412237",0,6,0,4,0,4
"3836","10412241",0,8,7,9,1,17
"3837","10412306",0,6,7,6,1,14
"3838","10412411",0,6,1,2,0,3
"3839","10412502",0,3,0,0,0,0
"3840","10412504",0,4,0,0,0,0
"3841","10412513",0,4,0,2,0,2
"3842","10412528",0,6,10,1,0,11
"3843","10412553",0,5,8,2,0,10
"3844","10412591",0,4,0,0,0,0
"3845","10412605",0,3,3,2,0,5
"3846","10412620",0,6,0,0,0,0
"3847","10412656",0,4,3,2,0,5
"3848","10412657",0,1,0,0,0,0
"3849","10412660",0,7,8,10,1,19
"3850","10412667",0,1,0,0,0,0
"3851","10412725",0,4,0,0,0,0
"3852","10412786",0,9,7,7,2,16
"3853","10412822",0,4,1,0,0,1
"3854","10412847",0,4,2,0,0,2
"3855","10412862",1,4,1,0,0,1
"3856","10412863",1,4,4,4,0,8
"3857","10412867",0,4,5,2,0,7
"3858","10412920",0,1,0,1,0,1
"3859","10412936",0,3,0,0,0,0
"3860","10412938",0,2,0,4,0,4
"3861","10412990",0,4,2,2,0,4
"3862","10413063",0,3,2,0,0,2
"3863","10413129",0,2,0,0,0,0
"3864","10413148",0,3,0,0,0,0
"3865","10413151",0,5,9,3,1,13
"3866","10413157",0,7,2,5,0,7
"3867","10413245",0,4,6,1,0,7
"3868","10413261",0,3,0,0,0,0
"3869","10413308",0,2,0,1,0,1
"3870","10413462",0,4,1,0,0,1
"3871","10413548",0,3,3,0,0,3
"3872","10413697",0,4,3,0,0,3
"3873","10413761",0,3,0,0,0,0
"3874","10413899",0,4,11,1,0,12
"3875","10413939",0,1,0,0,0,0
"3876","10413941",0,3,0,0,0,0
"3877","10413954",0,3,0,0,0,0
"3878","10413985",0,3,1,1,0,2
"3879","10413990",0,4,2,1,0,3
"3880","10413992",0,4,3,1,0,4
"3881","10413993",0,13,12,9,5,26
"3882","10414006",0,6,1,4,1,6
"3883","10414022",0,7,1,3,1,5
"3884","10414061",0,3,0,1,0,1
"3885","10414134",0,5,3,5,2,10
"3886","10414262",0,7,6,3,0,9
"3887","10414319",0,1,1,0,0,1
"3888","10414342",0,4,0,0,0,0
"3889","10414415",0,4,2,0,0,2
"3890","10414417",0,1,0,0,0,0
"3891","10414425",0,1,1,1,0,2
"3892","10414488",0,6,8,3,0,11
"3893","10414693",0,4,3,3,0,6
"3894","10414767",0,3,4,0,0,4
"3895","10414845",0,4,0,1,0,1
"3896","10414872",0,5,2,7,0,9
"3897","10414928",0,3,1,0,0,1
"3898","10415031",0,5,0,0,0,0
"3899","10415105",0,4,0,0,0,0
"3900","10415112",0,4,2,0,0,2
"3901","10415118",0,9,18,7,0,25
"3902","10415149",0,2,0,1,0,1
"3903","10415151",0,3,4,1,0,5
"3904","10415269",0,1,0,0,0,0
"3905","10415271",0,1,0,1,0,1
"3906","10415292",0,5,6,1,0,7
"3907","10415328",0,4,1,0,0,1
"3908","10415340",0,5,3,0,0,3
"3909","10415373",1,6,5,2,0,7
"3910","10415375",0,4,0,0,0,0
"3911","10415382",0,4,7,1,0,8
"3912","10415393",0,1,1,1,0,2
"3913","10415402",0,4,0,0,0,0
"3914","10415429",0,4,5,2,0,7
"3915","10415462",0,5,11,5,0,16
"3916","10415494",0,4,2,2,1,5
"3917","10415527",0,4,3,0,0,3
"3918","10415555",0,3,0,0,0,0
"3919","10415595",0,4,7,2,0,9
"3920","10415603",0,6,11,6,1,18
"3921","10415719",0,3,0,0,0,0
"3922","10415811",0,5,4,3,0,7
"3923","10415950",0,6,0,2,0,2
"3924","10415994",0,9,10,8,2,20
"3925","10416018",0,4,1,1,0,2
"3926","10416035",0,3,4,0,0,4
"3927","10416044",0,5,6,1,0,7
"3928","10416133",0,3,0,0,0,0
"3929","10416144",0,7,5,6,0,11
"3930","10416166",0,8,3,3,0,6
"3931","10416196",0,3,0,0,0,0
"3932","10416229",0,4,0,1,0,1
"3933","10416281",0,9,4,8,2,14
"3934","10416394",0,4,5,2,0,7
"3935","10416397",0,2,1,1,0,2
"3936","10416403",0,4,0,0,0,0
"3937","10416565",0,1,0,0,0,0
"3938","10416641",0,3,1,0,0,1
"3939","10416705",0,7,7,11,1,19
"3940","10416711",0,6,5,3,0,8
"3941","10416756",0,7,5,2,0,7
"3942","10416827",0,5,1,1,0,2
"3943","10416877",0,4,0,0,0,0
"3944","10416886",0,5,12,6,0,18
"3945","10416890",0,1,1,0,0,1
"3946","10416891",0,1,0,0,0,0
"3947","10416913",0,4,0,0,0,0
"3948","10416921",0,3,0,3,0,3
"3949","10416936",0,4,0,2,0,2
"3950","10416940",1,6,1,3,0,4
"3951","10416943",0,7,7,4,0,11
"3952","10416999",0,3,1,1,0,2
"3953","10417008",0,5,4,2,0,6
"3954","10417108",0,7,6,3,0,9
"3955","10417134",0,4,0,0,0,0
"3956","10417143",0,8,2,4,1,7
"3957","10417212",0,1,0,0,0,0
"3958","10417228",0,7,3,1,1,5
"3959","10417240",0,3,2,4,1,7
"3960","10417265",0,6,0,0,0,0
"3961","10417361",0,7,12,5,1,18
"3962","10417420",0,2,0,0,0,0
"3963","10417459",1,4,0,0,0,0
"3964","10417486",0,10,16,4,1,21
"3965","10417519",1,4,1,1,0,2
"3966","10417544",0,2,0,0,0,0
"3967","10417554",0,4,0,0,0,0
"3968","10417641",0,3,2,0,0,2
"3969","10417646",0,1,0,0,0,0
"3970","10417648",0,4,0,1,0,1
"3971","10417649",0,3,0,2,0,2
"3972","10417650",0,1,0,0,0,0
"3973","10417652",0,1,0,0,0,0
"3974","10417653",0,3,0,0,0,0
"3975","10417662",0,1,1,0,0,1
"3976","10417676",0,4,2,0,0,2
"3977","10417679",0,1,0,0,0,0
"3978","10417751",0,5,10,6,0,16
"3979","10417817",0,1,1,0,0,1
"3980","10417826",0,4,6,2,0,8
"3981","10417982",0,2,0,0,0,0
"3982","10417984",0,4,0,0,0,0
"3983","10417993",0,3,1,0,0,1
"3984","10418089",0,2,0,0,0,0
"3985","10418094",0,2,0,0,0,0
"3986","10418132",0,6,3,5,2,10
"3987","10418189",0,6,0,0,0,0
"3988","10418192",0,8,5,6,2,13
"3989","10418210",0,7,8,4,2,14
"3990","10418219",0,3,4,0,0,4
"3991","10418231",1,4,1,1,0,2
"3992","10418304",0,3,0,1,0,1
"3993","10418540",0,4,3,4,0,7
"3994","10418570",0,4,0,0,0,0
"3995","10418604",0,5,2,0,0,2
"3996","10418709",0,3,3,0,0,3
"3997","10418763",0,4,11,0,0,11
"3998","10418768",0,7,2,2,0,4
"3999","10418773",0,3,0,2,0,2
"4000","10418878",0,1,0,0,0,0
"4001","10418919",0,10,7,11,3,21
"4002","10418923",0,5,2,0,0,2
"4003","10419130",0,1,1,0,0,1
"4004","10419214",0,2,2,1,0,3
"4005","10419528",0,7,2,0,0,2
"4006","10419624",0,3,6,1,0,7
"4007","10419672",0,2,1,0,0,1
"4008","10419705",0,3,0,0,0,0
"4009","10419735",0,5,3,0,0,3
"4010","10419750",0,2,0,0,0,0
"4011","10419810",0,4,5,2,0,7
"4012","10419889",0,1,0,0,0,0
"4013","10419894",0,1,0,0,0,0
"4014","10419896",0,4,0,0,0,0
"4015","10419900",0,4,0,0,0,0
"4016","10419905",0,4,0,0,0,0
"4017","10420188",0,2,2,0,0,2
"4018","10420206",0,1,0,0,0,0
"4019","10420207",0,4,2,1,0,3
"4020","10420296",0,4,4,1,0,5
"4021","10420308",0,1,0,0,0,0
"4022","10420375",0,5,6,1,0,7
"4023","10420379",0,1,0,0,0,0
"4024","10420383",0,6,8,1,0,9
"4025","10420422",0,2,1,1,0,2
"4026","10420431",0,6,9,7,0,16
"4027","10420494",0,1,0,1,0,1
"4028","10420501",0,2,1,1,0,2
"4029","10420502",0,3,1,0,0,1
"4030","10420513",1,3,0,0,0,0
"4031","10420579",0,5,0,1,0,1
"4032","10420602",0,4,2,0,0,2
"4033","10420632",0,2,4,3,0,7
"4034","10420645",0,3,0,0,0,0
"4035","10420648",0,4,1,0,0,1
"4036","10420704",0,2,0,0,0,0
"4037","10420707",0,2,0,0,0,0
"4038","10420717",0,15,33,16,2,51
"4039","10420761",0,4,3,0,0,3
"4040","10420763",0,1,0,0,0,0
"4041","10420772",0,1,0,0,0,0
"4042","10420775",0,1,0,0,0,0
"4043","10420793",0,4,4,2,0,6
"4044","10420817",1,3,0,0,0,0
"4045","10420840",0,1,0,0,0,0
"4046","10420849",0,3,1,2,0,3
"4047","10420859",0,5,3,5,0,8
"4048","10420908",0,8,10,16,3,29
"4049","10420910",0,4,6,1,0,7
"4050","10420928",0,9,5,6,1,12
"4051","10420931",0,6,9,5,0,14
"4052","10420940",0,8,6,6,0,12
"4053","10420952",0,7,3,4,0,7
"4054","10420962",0,1,2,0,0,2
"4055","10421015",0,2,1,0,0,1
"4056","10421047",0,9,10,12,1,23
"4057","10421091",0,3,0,0,0,0
"4058","10421115",0,5,4,4,0,8
"4059","10421132",0,6,6,14,1,21
"4060","10421147",0,7,11,3,0,14
"4061","10421322",0,4,0,0,0,0
"4062","10421323",0,1,0,0,0,0
"4063","10421368",0,1,0,0,0,0
"4064","10421388",0,8,14,7,2,23
"4065","10421404",0,1,0,1,0,1
"4066","10421430",0,1,0,0,0,0
"4067","10421455",0,4,2,0,0,2
"4068","10421566",0,1,1,0,0,1
"4069","10421573",0,7,11,3,0,14
"4070","10421582",0,7,14,25,2,41
"4071","10421597",0,2,1,1,0,2
"4072","10421604",0,7,10,2,0,12
"4073","10421628",0,4,2,0,0,2
"4074","10421675",0,3,1,1,0,2
"4075","10421677",0,4,5,2,0,7
"4076","10421683",0,4,3,1,0,4
"4077","10421687",0,1,0,0,0,0
"4078","10421688",0,2,0,0,0,0
"4079","10421689",0,3,4,3,0,7
"4080","10421720",0,3,5,0,0,5
"4081","10421723",0,4,6,0,0,6
"4082","10421725",0,4,2,0,0,2
"4083","10421737",0,1,0,0,0,0
"4084","10421767",0,1,1,0,0,1
"4085","10421805",0,4,0,0,0,0
"4086","10421806",0,3,3,0,0,3
"4087","10421807",0,2,0,0,0,0
"4088","10421809",0,7,10,1,1,12
"4089","10421811",0,3,1,2,1,4
"4090","10421813",0,6,0,0,0,0
"4091","10421816",0,3,0,0,0,0
"4092","10421817",0,4,2,0,0,2
"4093","10421823",0,4,1,0,0,1
"4094","10421824",0,3,0,0,0,0
"4095","10421826",0,4,0,0,0,0
"4096","10421830",0,3,1,0,0,1
"4097","10421831",0,4,0,0,0,0
"4098","10421903",0,7,4,4,0,8
"4099","10421928",0,4,3,4,0,7
"4100","10421930",0,4,4,0,0,4
"4101","10422127",0,1,0,0,0,0
"4102","10422256",0,1,0,0,0,0
"4103","10422263",0,1,0,0,0,0
"4104","10422283",0,8,8,8,1,17
"4105","10422284",0,1,0,0,0,0
"4106","10422285",1,4,2,0,0,2
"4107","10422303",0,3,0,3,0,3
"4108","10422335",0,1,1,0,0,1
"4109","10422337",0,1,0,0,0,0
"4110","10422339",0,1,1,0,0,1
"4111","10422341",0,1,0,0,0,0
"4112","10422346",0,6,10,4,0,14
"4113","10422352",0,1,0,0,0,0
"4114","10422370",0,3,1,1,0,2
"4115","10422390",0,2,0,0,0,0
"4116","10422434",0,1,0,0,0,0
"4117","10422575",0,4,0,2,0,2
"4118","10422591",0,5,2,0,0,2
"4119","10422596",0,2,0,0,0,0
"4120","10422615",0,5,10,0,0,10
"4121","10422619",0,1,0,0,0,0
"4122","10422680",0,2,0,0,0,0
"4123","10422728",0,1,0,0,0,0
"4124","10422738",0,5,4,2,0,6
"4125","10422742",0,5,0,0,0,0
"4126","10422744",0,3,0,0,0,0
"4127","10422749",0,4,5,2,0,7
"4128","10422767",0,4,0,0,0,0
"4129","10422768",0,4,0,0,0,0
"4130","10422809",0,1,0,0,0,0
"4131","10422840",0,4,1,0,0,1
"4132","10422891",0,1,2,0,0,2
"4133","10422893",0,4,0,0,0,0
"4134","10422941",0,2,1,0,0,1
"4135","10422958",0,3,5,0,0,5
"4136","10423014",0,1,0,0,0,0
"4137","10423020",0,3,2,5,0,7
"4138","10423048",0,4,0,2,0,2
"4139","10423055",0,3,3,0,0,3
"4140","10423125",0,2,0,2,0,2
"4141","10423143",0,2,1,0,0,1
"4142","10423151",0,5,3,3,0,6
"4143","10423167",0,3,1,0,0,1
"4144","10423204",0,2,0,0,0,0
"4145","10423232",0,3,2,1,0,3
"4146","10423234",0,4,0,1,0,1
"4147","10423366",0,4,1,1,0,2
"4148","10423377",0,3,0,0,0,0
"4149","10423394",0,1,1,2,0,3
"4150","10423481",0,2,2,0,0,2
"4151","10423485",0,3,6,5,0,11
"4152","10423523",0,6,4,11,1,16
"4153","10423551",0,4,0,2,0,2
"4154","10423585",0,2,2,0,0,2
"4155","10423690",0,1,0,0,0,0
"4156","10423704",0,1,0,0,0,0
"4157","10423709",0,7,1,0,0,1
"4158","10423823",1,6,0,2,0,2
"4159","10424101",0,3,0,2,0,2
"4160","10424208",0,1,0,0,0,0
"4161","10424357",0,5,2,0,0,2
"4162","10424363",0,1,1,0,0,1
"4163","10424367",0,2,0,1,0,1
"4164","10424392",0,3,0,0,0,0
"4165","10424443",0,6,5,2,0,7
"4166","10424457",1,4,0,0,0,0
"4167","10424506",0,5,3,4,0,7
"4168","10424514",0,2,0,0,0,0
"4169","10424563",0,3,0,0,0,0
"4170","10424564",0,5,3,3,0,6
"4171","10424586",0,3,0,0,0,0
"4172","10424650",0,4,1,4,0,5
"4173","10424652",0,4,5,2,0,7
"4174","10424719",0,4,2,2,0,4
"4175","10424859",0,7,8,2,0,10
"4176","10424863",0,1,0,0,0,0
"4177","10424977",0,4,0,0,0,0
"4178","10425176",0,4,2,1,0,3
"4179","10425269",0,4,2,1,0,3
"4180","10425319",0,4,0,0,0,0
"4181","10425346",0,5,9,1,0,10
"4182","10425451",0,2,1,2,0,3
"4183","10425456",0,4,1,0,0,1
"4184","10425457",0,6,3,0,0,3
"4185","10425503",0,4,2,2,0,4
"4186","10425596",0,3,0,0,1,1
"4187","10425603",0,8,5,7,2,14
"4188","10425614",0,1,0,0,0,0
"4189","10425649",0,2,2,2,0,4
"4190","10425656",0,5,2,1,0,3
"4191","10425685",0,7,2,1,0,3
"4192","10425722",0,5,0,0,0,0
"4193","10425780",0,6,6,1,0,7
"4194","10425808",0,5,1,8,1,10
"4195","10425926",0,5,3,0,0,3
"4196","10425949",0,4,2,2,0,4
"4197","10425990",0,4,2,0,0,2
"4198","10426002",0,6,0,2,0,2
"4199","10426009",0,1,0,0,0,0
"4200","10426030",0,4,0,0,0,0
"4201","10426033",0,4,0,0,0,0
"4202","10426100",0,5,1,0,0,1
"4203","10426113",0,4,0,1,0,1
"4204","10426150",0,1,0,0,0,0
"4205","10426154",0,4,1,0,0,1
"4206","10426186",0,5,4,1,0,5
"4207","10426188",0,5,5,6,0,11
"4208","10426194",0,7,5,2,0,7
"4209","10426302",0,6,0,0,0,0
"4210","10426309",0,5,3,2,0,5
"4211","10426343",0,7,6,0,1,7
"4212","10426406",0,7,4,2,1,7
"4213","10426416",0,5,2,0,0,2
"4214","10426474",0,9,8,9,1,18
"4215","10426520",0,4,4,1,0,5
"4216","10426525",1,4,3,2,0,5
"4217","10426563",0,3,3,0,0,3
"4218","10426580",0,4,2,4,1,7
"4219","10426586",0,3,4,2,0,6
"4220","10426598",0,6,5,12,0,17
"4221","10426606",0,10,18,13,4,35
"4222","10426623",0,5,1,0,0,1
"4223","10426637",0,2,0,0,0,0
"4224","10426684",0,5,3,4,0,7
"4225","10426726",0,8,20,5,0,25
"4226","10426788",0,3,2,0,0,2
"4227","10426840",0,3,0,0,0,0
"4228","10426845",0,3,1,0,0,1
"4229","10426846",0,4,3,3,0,6
"4230","10426856",0,1,0,0,0,0
"4231","10426969",1,4,0,1,0,1
"4232","10427013",0,2,2,1,0,3
"4233","10427085",0,2,1,0,0,1
"4234","10427159",0,4,4,2,0,6
"4235","10427163",0,4,1,4,0,5
"4236","10427172",0,9,3,1,2,6
"4237","10427187",0,9,8,1,0,9
"4238","10427233",0,5,5,4,0,9
"4239","10427237",0,1,3,0,0,3
"4240","10427264",0,6,3,7,1,11
"4241","10427267",0,4,2,1,0,3
"4242","10427269",0,6,9,5,0,14
"4243","10427416",0,1,2,2,0,4
"4244","10427452",0,4,3,0,0,3
"4245","10427534",0,4,3,0,0,3
"4246","10427544",0,4,1,0,0,1
"4247","10427546",0,5,3,3,0,6
"4248","10427559",0,7,3,10,2,15
"4249","10427594",0,4,0,3,0,3
"4250","10427619",1,5,0,0,0,0
"4251","10427628",0,3,1,0,0,1
"4252","10427669",0,3,2,3,0,5
"4253","10427675",0,6,1,1,0,2
"4254","10427706",0,4,2,0,0,2
"4255","10427712",0,5,7,3,0,10
"4256","10427945",0,5,1,2,0,3
"4257","10427952",0,1,1,0,0,1
"4258","10428018",0,4,0,0,0,0
"4259","10428031",0,1,0,0,0,0
"4260","10428037",0,2,0,0,0,0
"4261","10428168",0,1,0,0,0,0
"4262","10428197",0,1,2,1,0,3
"4263","10428203",0,7,4,2,0,6
"4264","10428208",0,8,18,13,1,32
"4265","10428271",0,5,10,3,0,13
"4266","10428320",0,3,1,2,0,3
"4267","10428325",0,3,0,0,0,0
"4268","10428332",0,5,0,1,0,1
"4269","10428336",0,6,8,1,0,9
"4270","10428416",0,6,5,4,0,9
"4271","10428423",0,3,0,0,0,0
"4272","10428468",0,1,0,0,0,0
"4273","10428480",0,4,0,0,0,0
"4274","10428540",0,3,1,0,0,1
"4275","10428659",0,6,0,0,0,0
"4276","10428707",0,4,1,0,0,1
"4277","10428750",0,1,0,1,0,1
"4278","10428770",0,2,1,0,0,1
"4279","10428815",0,4,1,0,0,1
"4280","10428918",0,4,4,0,0,4
"4281","10428955",0,4,2,0,0,2
"4282","10428958",0,3,3,1,0,4
"4283","10428961",0,4,0,0,0,0
"4284","10428963",0,1,0,0,0,0
"4285","10429023",0,3,2,3,0,5
"4286","10429055",0,1,0,2,0,2
"4287","10429058",0,4,5,3,0,8
"4288","10429136",0,4,1,1,0,2
"4289","10429215",0,1,0,0,0,0
"4290","10429323",0,5,2,1,0,3
"4291","10429324",0,5,0,1,0,1
"4292","10429355",0,6,6,5,0,11
"4293","10429379",0,2,0,0,0,0
"4294","10429437",0,8,7,9,1,17
"4295","10429514",0,5,0,4,0,4
"4296","10429520",0,4,4,0,0,4
"4297","10429580",0,9,11,8,1,20
"4298","10429697",0,4,3,0,0,3
"4299","10429769",0,4,3,0,0,3
"4300","10429778",0,7,10,4,0,14
"4301","10429824",0,4,4,3,0,7
"4302","10429826",0,10,6,14,3,23
"4303","10429872",0,3,3,2,0,5
"4304","10429986",0,5,3,2,0,5
"4305","10430010",0,4,0,0,0,0
"4306","10430013",0,4,1,2,0,3
"4307","10430014",0,3,0,0,0,0
"4308","10430127",0,3,4,0,0,4
"4309","10430153",0,3,8,3,0,11
"4310","10430286",0,3,2,0,0,2
"4311","10430292",0,3,4,0,0,4
"4312","10430368",0,6,0,0,0,0
"4313","10430383",0,4,1,2,0,3
"4314","10430607",0,1,0,0,0,0
"4315","10430637",0,4,2,2,0,4
"4316","10430642",0,2,1,1,0,2
"4317","10430733",0,2,1,4,0,5
"4318","10430784",0,3,1,2,0,3
"4319","10430795",0,4,0,0,0,0
"4320","10430798",0,4,2,0,0,2
"4321","10430814",0,5,8,7,0,15
"4322","10430850",0,1,0,0,0,0
"4323","10430871",0,7,1,1,0,2
"4324","10430888",0,6,9,5,0,14
"4325","10430892",0,5,0,0,0,0
"4326","10430908",0,5,1,1,0,2
"4327","10430927",0,7,12,6,2,20
"4328","10430961",0,5,0,2,0,2
"4329","10431007",0,1,1,0,0,1
"4330","10431013",0,4,1,0,0,1
"4331","10431055",1,4,0,0,0,0
"4332","10431057",1,4,0,1,0,1
"4333","10431102",0,6,9,4,0,13
"4334","10431154",0,3,0,0,0,0
"4335","10431163",0,2,0,1,0,1
"4336","10431176",0,4,0,3,0,3
"4337","10431193",0,7,0,1,0,1
"4338","10431233",0,4,2,2,0,4
"4339","10431236",0,7,8,7,1,16
"4340","10431245",0,5,5,2,0,7
"4341","10431269",0,4,2,2,0,4
"4342","10431304",0,2,2,0,0,2
"4343","10431317",0,2,3,1,0,4
"4344","10431413",0,3,0,0,0,0
"4345","10431423",0,8,9,2,1,12
"4346","10431433",0,1,0,0,0,0
"4347","10431468",0,4,0,0,0,0
"4348","10431473",0,6,7,8,0,15
"4349","10431489",0,5,3,5,2,10
"4350","10431511",0,4,3,1,0,4
"4351","10431533",0,2,0,0,0,0
"4352","10431535",0,2,0,0,0,0
"4353","10431536",0,3,3,2,0,5
"4354","10431690",0,4,0,0,0,0
"4355","10431696",0,6,9,3,0,12
"4356","10431763",0,3,0,0,0,0
"4357","10431767",0,2,0,0,0,0
"4358","10431838",0,1,0,0,0,0
"4359","10431870",0,5,0,1,0,1
"4360","10431959",0,1,0,0,0,0
"4361","10431977",0,4,3,1,0,4
"4362","10431981",0,4,0,1,0,1
"4363","10431986",1,5,2,1,0,3
"4364","10431990",0,1,0,0,0,0
"4365","10432094",0,1,3,0,0,3
"4366","10432103",0,2,0,1,0,1
"4367","10432104",0,5,0,0,0,0
"4368","10432129",0,3,0,0,0,0
"4369","10432144",0,1,0,1,0,1
"4370","10432206",0,5,4,1,0,5
"4371","10432210",0,5,5,0,0,5
"4372","10432221",0,1,0,0,0,0
"4373","10432240",0,4,3,2,0,5
"4374","10432293",0,3,0,1,0,1
"4375","10432333",0,5,2,4,0,6
"4376","10432377",0,5,8,5,1,14
"4377","10432398",0,7,11,5,0,16
"4378","10432406",0,5,2,0,0,2
"4379","10432492",0,4,0,0,0,0
"4380","10432616",0,1,0,0,0,0
"4381","10432654",0,5,8,1,0,9
"4382","10432665",0,7,11,2,0,13
"4383","10432684",0,4,0,0,0,0
"4384","10432734",0,6,12,8,4,24
"4385","10432816",0,5,10,1,0,11
"4386","10432837",0,3,6,0,0,6
"4387","10432878",0,4,0,1,0,1
"4388","10432984",0,2,0,0,0,0
"4389","10433028",0,4,1,0,0,1
"4390","10433043",0,5,1,0,0,1
"4391","10433093",1,5,3,0,0,3
"4392","10433101",0,1,0,0,0,0
"4393","10433116",0,4,0,1,0,1
"4394","10433183",0,5,7,8,0,15
"4395","10433259",0,8,13,5,0,18
"4396","10433285",0,5,8,5,0,13
"4397","10433360",0,5,2,4,0,6
"4398","10433363",0,2,3,2,0,5
"4399","10433379",0,6,5,0,0,5
"4400","10433418",0,1,1,0,0,1
"4401","10433448",0,2,0,0,0,0
"4402","10433454",0,3,0,0,0,0
"4403","10433468",0,4,1,0,0,1
"4404","10433470",0,1,0,0,0,0
"4405","10433507",0,4,0,2,0,2
"4406","10433511",0,3,2,1,0,3
"4407","10433513",0,2,1,0,0,1
"4408","10433514",0,4,1,0,0,1
"4409","10433552",0,5,8,5,0,13
"4410","10433555",0,6,6,3,0,9
"4411","10433556",0,7,11,2,1,14
"4412","10433558",0,6,5,4,0,9
"4413","10433611",0,1,1,0,0,1
"4414","10433626",0,5,2,1,1,4
"4415","10433647",0,3,1,0,0,1
"4416","10433652",0,4,7,0,0,7
"4417","10433662",0,4,4,3,0,7
"4418","10433691",0,5,3,1,0,4
"4419","10433717",0,2,0,2,0,2
"4420","10433730",0,1,1,0,0,1
"4421","10433754",0,4,3,1,0,4
"4422","10433831",0,4,0,0,0,0
"4423","10433833",0,3,0,0,0,0
"4424","10433837",0,3,0,0,0,0
"4425","10433840",0,1,0,0,0,0
"4426","10433887",0,3,1,1,0,2
"4427","10433958",0,5,0,2,0,2
"4428","10433969",0,5,2,7,0,9
"4429","10433986",0,5,12,5,0,17
"4430","10434017",0,6,3,5,1,9
"4431","10434022",0,3,1,0,0,1
"4432","10434045",0,6,11,7,1,19
"4433","10434064",0,5,3,7,2,12
"4434","10434127",0,7,7,1,0,8
"4435","10434157",0,3,4,0,0,4
"4436","10434158",0,5,3,8,0,11
"4437","10434163",0,5,10,9,1,20
"4438","10434167",0,3,0,0,0,0
"4439","10434171",0,4,0,0,0,0
"4440","10434173",0,5,1,1,0,2
"4441","10434178",0,2,0,0,0,0
"4442","10434190",0,4,4,0,0,4
"4443","10434229",0,3,0,0,0,0
"4444","10434264",0,5,3,6,1,10
"4445","10434270",0,3,2,1,0,3
"4446","10434272",0,2,3,0,0,3
"4447","10434345",0,5,6,0,0,6
"4448","10434356",0,4,0,1,0,1
"4449","10434361",0,5,9,1,0,10
"4450","10434480",0,2,3,0,0,3
"4451","10434519",0,2,0,0,0,0
"4452","10434544",0,1,0,0,0,0
"4453","10434549",0,2,0,0,0,0
"4454","10434551",0,4,0,0,0,0
"4455","10434552",0,3,0,0,0,0
"4456","10434554",0,5,4,6,0,10
"4457","10434602",0,5,4,5,0,9
"4458","10434623",0,5,6,2,0,8
"4459","10434709",0,1,1,0,0,1
"4460","10434748",0,4,1,2,0,3
"4461","10434803",0,3,0,0,0,0
"4462","10434823",0,4,6,2,0,8
"4463","10434841",0,5,1,0,0,1
"4464","10434843",0,4,0,0,0,0
"4465","10434846",0,2,0,0,0,0
"4466","10434890",0,3,3,2,0,5
"4467","10434893",0,5,3,2,2,7
"4468","10435011",0,4,5,0,0,5
"4469","10435063",0,3,0,0,0,0
"4470","10435152",0,3,0,0,0,0
"4471","10435186",0,8,7,5,0,12
"4472","10435195",0,2,2,2,0,4
"4473","10435210",0,5,6,0,0,6
"4474","10435255",1,4,0,0,0,0
"4475","10435431",0,4,2,0,0,2
"4476","10435472",0,4,2,2,0,4
"4477","10435484",0,3,4,1,0,5
"4478","10435517",0,5,0,0,0,0
"4479","10435530",0,4,7,2,0,9
"4480","10435531",0,1,0,0,0,0
"4481","10435532",0,5,11,3,0,14
"4482","10435618",0,3,0,0,0,0
"4483","10435705",0,1,0,0,0,0
"4484","10435706",0,5,4,1,0,5
"4485","10435714",0,2,0,0,0,0
"4486","10435716",0,5,2,2,0,4
"4487","10435807",0,3,2,6,0,8
"4488","10435902",0,1,0,2,0,2
"4489","10435921",0,2,3,0,0,3
"4490","10435958",0,4,2,1,0,3
"4491","10435994",0,7,5,4,3,12
"4492","10436018",0,3,0,0,0,0
"4493","10436136",0,7,1,0,0,1
"4494","10436227",0,1,0,0,0,0
"4495","10436233",0,2,3,1,0,4
"4496","10436312",0,1,0,0,0,0
"4497","10436391",0,4,2,0,0,2
"4498","10436393",0,4,0,0,0,0
"4499","10436400",0,2,2,3,0,5
"4500","10436401",0,3,0,0,0,0
"4501","10436424",0,4,0,0,0,0
"4502","10436427",0,3,1,0,0,1
"4503","10436432",0,3,2,0,0,2
"4504","10436465",0,5,6,4,0,10
"4505","10436513",0,6,12,0,0,12
"4506","10436541",0,1,0,0,0,0
"4507","10436565",0,6,10,2,1,13
"4508","10436602",0,4,1,0,0,1
"4509","10436726",0,8,1,1,1,3
"4510","10436755",0,5,0,0,0,0
"4511","10436768",0,5,2,0,0,2
"4512","10436770",0,6,0,0,0,0
"4513","10436793",0,3,0,0,0,0
"4514","10436976",0,3,4,1,0,5
"4515","10436991",0,3,0,0,0,0
"4516","10436994",0,5,0,0,0,0
"4517","10437013",0,5,2,2,0,4
"4518","10437206",0,3,0,0,0,0
"4519","10437254",0,5,10,1,0,11
"4520","10437255",0,4,1,0,0,1
"4521","10437273",0,2,0,1,0,1
"4522","10437276",0,4,6,0,0,6
"4523","10437320",0,6,3,1,0,4
"4524","10437328",0,4,0,1,0,1
"4525","10437407",0,3,6,3,0,9
"4526","10437426",0,7,5,4,0,9
"4527","10437451",0,5,3,2,1,6
"4528","10437459",0,4,0,0,0,0
"4529","10437499",0,4,0,0,0,0
"4530","10437620",0,4,2,1,0,3
"4531","10437623",0,4,3,4,0,7
"4532","10437641",0,3,2,1,0,3
"4533","10437645",0,4,1,3,0,4
"4534","10437674",0,4,1,5,0,6
"4535","10437681",0,5,3,1,0,4
"4536","10437682",0,6,13,3,0,16
"4537","10437683",0,2,0,0,0,0
"4538","10437685",0,4,5,2,0,7
"4539","10437692",0,5,5,5,0,10
"4540","10437745",0,7,11,8,0,19
"4541","10437876",0,1,0,0,0,0
"4542","10437960",0,2,0,0,0,0
"4543","10438034",0,4,0,0,0,0
"4544","10438042",0,6,3,2,0,5
"4545","10438053",0,4,2,0,0,2
"4546","10438079",0,4,2,1,0,3
"4547","10438242",0,5,9,7,2,18
"4548","10438243",0,5,0,0,0,0
"4549","10438265",0,1,0,0,0,0
"4550","10438455",0,6,7,2,0,9
"4551","10438462",0,3,4,0,0,4
"4552","10438579",0,6,2,0,0,2
"4553","10438627",0,9,11,10,1,22
"4554","10438702",0,3,7,5,0,12
"4555","10438750",0,4,3,0,0,3
"4556","10438760",0,4,0,0,0,0
"4557","10438919",0,10,14,9,0,23
"4558","10439170",0,3,1,0,0,1
"4559","10439219",0,1,1,0,0,1
"4560","10439230",0,2,1,0,0,1
"4561","10439295",0,8,15,5,3,23
"4562","10439371",0,1,0,0,0,0
"4563","10439465",0,3,1,0,0,1
"4564","10439472",0,4,7,1,0,8
"4565","10439515",0,3,0,0,0,0
"4566","10439517",0,4,1,0,0,1
"4567","10439541",0,2,2,0,0,2
"4568","10439594",0,6,4,3,3,10
"4569","10439623",0,6,4,6,0,10
"4570","10439688",0,7,14,14,1,29
"4571","10439701",0,4,5,0,0,5
"4572","10439704",0,4,3,0,0,3
"4573","10439706",0,5,2,1,0,3
"4574","10439708",0,3,1,0,0,1
"4575","10439765",0,1,1,0,0,1
"4576","10439791",0,4,3,0,0,3
"4577","10439934",0,3,2,0,0,2
"4578","10440028",1,4,1,1,0,2
"4579","10440060",0,5,7,0,0,7
"4580","10440179",0,13,18,6,0,24
"4581","10440281",0,3,7,0,0,7
"4582","10440332",1,10,8,15,3,26
"4583","10440386",0,2,1,0,0,1
"4584","10440400",0,5,1,2,2,5
"4585","10440411",0,3,4,4,0,8
"4586","10440550",0,7,1,3,0,4
"4587","10440585",0,4,4,4,0,8
"4588","10440792",1,4,0,0,0,0
"4589","10440820",0,4,0,0,0,0
"4590","10440869",0,6,6,7,1,14
"4591","10440871",0,4,2,1,0,3
"4592","10441031",0,6,10,4,0,14
"4593","10441100",0,7,2,3,3,8
"4594","10441188",0,2,1,1,1,3
"4595","10441193",0,5,2,6,0,8
"4596","10441195",0,6,2,3,0,5
"4597","10441441",0,8,15,8,0,23
"4598","10441472",1,4,0,1,0,1
"4599","10441473",1,4,0,0,0,0
"4600","10441474",1,4,0,0,0,0
"4601","10441561",0,3,5,1,0,6
"4602","10441591",0,6,12,4,0,16
"4603","10441596",0,2,1,1,0,2
"4604","10441625",0,3,0,0,0,0
"4605","10441754",0,3,0,0,0,0
"4606","10441925",1,5,0,0,0,0
"4607","10441932",1,4,0,0,0,0
"4608","10441939",1,3,0,0,0,0
"4609","10441943",1,5,0,0,0,0
"4610","10441953",0,4,0,0,0,0
"4611","10441959",0,4,0,0,0,0
"4612","10441981",0,6,1,0,0,1
"4613","10442034",0,4,1,0,0,1
"4614","10442076",0,4,0,1,0,1
"4615","10442079",0,4,0,0,0,0
"4616","10442182",0,3,1,0,0,1
"4617","10442272",0,1,1,0,0,1
"4618","10442296",0,6,9,0,0,9
"4619","10442331",0,2,0,0,0,0
"4620","10442338",0,2,2,2,0,4
"4621","10442433",0,1,0,0,0,0
"4622","10442446",0,4,0,0,0,0
"4623","10442463",0,2,0,0,0,0
"4624","10442525",0,4,0,0,0,0
"4625","10442556",0,1,0,0,0,0
"4626","10442570",0,1,0,0,0,0
"4627","10442585",0,4,2,1,0,3
"4628","10442603",0,4,6,1,0,7
"4629","10442604",0,7,3,1,0,4
"4630","10442626",0,3,3,0,0,3
"4631","10442671",0,4,0,0,0,0
"4632","10442673",0,4,0,2,0,2
"4633","10442688",0,4,8,2,0,10
"4634","10442746",0,4,2,2,0,4
"4635","10442783",0,5,5,0,0,5
"4636","10442789",0,4,7,1,0,8
"4637","10442798",0,1,0,0,0,0
"4638","10442801",0,1,0,0,0,0
"4639","10442828",0,2,0,0,0,0
"4640","10442844",0,2,1,1,0,2
"4641","10442873",0,4,1,1,0,2
"4642","10442905",0,3,0,1,0,1
"4643","10442906",0,3,0,0,0,0
"4644","10442928",0,2,0,0,0,0
"4645","10442983",0,1,0,1,0,1
"4646","10443003",0,7,9,9,1,19
"4647","10443069",0,3,0,0,0,0
"4648","10443135",0,1,0,0,0,0
"4649","10443238",0,6,0,0,0,0
"4650","10443259",0,6,3,2,0,5
"4651","10443295",0,7,4,5,0,9
"4652","10443343",0,5,2,2,1,5
"4653","10443350",0,9,9,4,1,14
"4654","10443468",0,2,0,0,0,0
"4655","10443482",0,3,0,0,0,0
"4656","10443629",0,6,4,3,1,8
"4657","10443704",0,5,1,3,0,4
"4658","10443766",0,5,5,2,0,7
"4659","10443795",0,6,2,3,0,5
"4660","10443822",0,4,3,1,0,4
"4661","10443834",1,5,5,2,0,7
"4662","10443850",0,1,0,0,0,0
"4663","10443891",0,4,0,0,0,0
"4664","10443935",0,4,4,1,0,5
"4665","10443969",0,9,18,7,1,26
"4666","10443994",0,7,3,7,0,10
"4667","10443999",0,2,0,2,0,2
"4668","10444075",1,7,1,3,0,4
"4669","10444112",0,4,0,1,0,1
"4670","10444119",0,4,0,0,0,0
"4671","10444134",0,4,0,1,0,1
"4672","10444250",0,1,0,0,0,0
"4673","10444407",0,5,0,0,0,0
"4674","10444483",0,2,0,0,0,0
"4675","10444531",0,2,1,0,0,1
"4676","10444563",0,4,0,0,0,0
"4677","10444572",0,6,4,3,0,7
"4678","10444600",0,4,5,7,0,12
"4679","10444601",0,4,0,0,0,0
"4680","10444617",0,4,0,0,0,0
"4681","10444735",0,6,2,4,0,6
"4682","10444803",0,3,1,0,0,1
"4683","10444806",0,8,4,10,1,15
"4684","10444835",0,1,0,0,0,0
"4685","10444875",0,3,0,0,0,0
"4686","10444876",0,5,9,4,1,14
"4687","10445123",0,4,0,2,1,3
"4688","10445194",0,1,2,0,0,2
"4689","10445326",0,6,10,3,0,13
"4690","10445327",0,4,4,0,0,4
"4691","10445407",0,4,5,2,0,7
"4692","10445455",0,4,3,1,0,4
"4693","10445478",1,4,0,1,0,1
"4694","10445509",0,3,1,0,0,1
"4695","10445517",0,5,0,2,0,2
"4696","10445527",0,3,0,0,0,0
"4697","10445640",0,4,1,0,0,1
"4698","10445655",0,4,0,0,0,0
"4699","10445669",1,1,0,1,0,1
"4700","10445674",1,1,0,0,0,0
"4701","10445734",0,1,0,0,0,0
"4702","10445765",0,1,2,0,0,2
"4703","10445767",0,10,13,14,3,30
"4704","10445908",0,2,0,0,0,0
"4705","10445967",0,4,1,1,0,2
"4706","10446013",0,1,0,0,0,0
"4707","10446043",0,4,4,0,0,4
"4708","10446077",0,5,6,2,1,9
"4709","10446086",0,4,1,1,0,2
"4710","10446090",0,4,0,0,0,0
"4711","10446096",0,5,2,5,0,7
"4712","10446163",0,4,7,1,0,8
"4713","10446252",0,1,1,0,0,1
"4714","10446314",0,1,0,0,0,0
"4715","10446375",0,4,0,0,0,0
"4716","10446411",0,1,0,0,0,0
"4717","10446415",0,6,3,1,1,5
"4718","10446459",0,4,1,1,0,2
"4719","10446495",0,2,0,0,0,0
"4720","10446509",0,1,0,0,0,0
"4721","10446513",1,5,2,3,0,5
"4722","10446526",0,4,1,0,0,1
"4723","10446530",0,4,7,1,0,8
"4724","10446559",0,3,3,3,0,6
"4725","10446741",0,4,0,0,0,0
"4726","10446754",0,3,0,0,0,0
"4727","10446777",0,4,4,1,0,5
"4728","10446848",0,4,5,1,0,6
"4729","10446851",0,1,2,1,0,3
"4730","10446905",0,3,2,6,0,8
"4731","10446906",0,4,1,2,0,3
"4732","10446959",0,1,0,0,0,0
"4733","10446972",0,3,2,0,0,2
"4734","10446993",0,3,0,1,0,1
"4735","10447070",0,2,2,2,0,4
"4736","10447071",0,2,0,0,0,0
"4737","10447074",0,4,2,0,0,2
"4738","10447086",0,2,0,0,0,0
"4739","10447104",0,4,3,5,1,9
"4740","10447119",0,3,4,1,0,5
"4741","10447128",0,2,1,0,0,1
"4742","10447153",0,2,1,0,0,1
"4743","10447170",0,6,0,1,0,1
"4744","10447174",0,4,1,0,0,1
"4745","10447216",0,1,1,0,0,1
"4746","10447260",0,2,0,0,0,0
"4747","10447308",1,1,0,0,0,0
"4748","10447317",0,4,6,1,0,7
"4749","10447333",0,4,0,0,0,0
"4750","10447335",0,4,1,2,0,3
"4751","10447386",0,1,0,0,0,0
"4752","10447388",0,2,0,0,0,0
"4753","10447429",0,6,4,3,0,7
"4754","10447470",0,3,0,0,0,0
"4755","10447474",0,1,0,1,0,1
"4756","10447500",0,2,0,0,0,0
"4757","10447511",0,5,9,2,0,11
"4758","10447525",0,4,0,0,0,0
"4759","10447526",0,3,0,0,0,0
"4760","10447537",0,5,4,0,0,4
"4761","10447558",0,4,5,0,0,5
"4762","10447563",0,3,1,0,0,1
"4763","10447569",0,4,2,3,0,5
"4764","10447575",0,5,1,0,0,1
"4765","10447647",0,3,0,0,0,0
"4766","10447674",0,7,10,9,0,19
"4767","10447704",0,4,2,3,0,5
"4768","10447804",1,4,2,2,0,4
"4769","10447822",0,5,1,0,0,1
"4770","10448080",0,1,0,0,0,0
"4771","10448090",0,4,0,0,0,0
"4772","10448263",0,4,2,5,0,7
"4773","10448295",0,4,6,0,0,6
"4774","10448333",0,3,0,0,0,0
"4775","10448342",0,2,0,0,0,0
"4776","10448348",0,3,0,0,0,0
"4777","10448352",0,3,0,0,0,0
"4778","10448353",0,2,0,0,0,0
"4779","10448354",0,1,0,0,0,0
"4780","10448357",0,3,0,0,0,0
"4781","10448359",0,3,1,0,0,1
"4782","10448368",0,7,1,1,0,2
"4783","10448376",0,2,0,0,0,0
"4784","10448379",0,3,2,0,0,2
"4785","10448382",0,3,0,0,0,0
"4786","10448400",0,1,0,0,0,0
"4787","10448416",0,3,0,0,0,0
"4788","10448423",0,3,0,0,0,0
"4789","10448483",0,5,10,4,0,14
"4790","10448491",0,3,3,0,0,3
"4791","10448538",0,4,1,1,0,2
"4792","10448541",0,4,0,0,0,0
"4793","10448589",0,3,2,1,0,3
"4794","10448613",0,4,3,2,0,5
"4795","10448624",0,4,0,3,0,3
"4796","10448697",0,4,0,0,0,0
"4797","10448698",0,5,1,1,0,2
"4798","10448707",0,4,0,2,0,2
"4799","10448718",0,1,0,0,0,0
"4800","10448740",0,3,3,3,0,6
"4801","10448751",1,8,7,4,0,11
"4802","10448762",0,4,1,0,0,1
"4803","10448789",0,6,7,4,1,12
"4804","10448809",0,1,0,0,0,0
"4805","10448815",0,1,2,0,0,2
"4806","10448824",0,1,0,0,0,0
"4807","10448844",0,2,0,1,0,1
"4808","10448863",0,2,0,0,0,0
"4809","10448879",0,6,2,1,0,3
"4810","10448882",0,3,1,0,0,1
"4811","10448908",0,2,0,0,0,0
"4812","10448916",0,1,0,0,0,0
"4813","10448944",0,4,1,1,0,2
"4814","10448961",0,4,2,0,0,2
"4815","10449055",0,2,0,0,0,0
"4816","10449059",0,8,3,3,0,6
"4817","10449069",0,3,0,0,0,0
"4818","10449077",0,3,3,1,0,4
"4819","10449104",0,4,0,0,0,0
"4820","10449141",0,5,3,0,0,3
"4821","10449290",0,3,0,0,0,0
"4822","10449301",0,6,0,1,0,1
"4823","10449321",0,2,2,1,0,3
"4824","10449350",0,4,1,0,0,1
"4825","10449364",1,5,0,0,0,0
"4826","10449389",0,3,4,3,0,7
"4827","10449401",0,3,0,0,0,0
"4828","10449414",0,4,7,0,0,7
"4829","10449417",0,4,3,2,0,5
"4830","10449426",0,2,2,0,0,2
"4831","10449537",0,6,0,0,0,0
"4832","10449620",1,3,2,1,0,3
"4833","10449628",0,4,0,0,0,0
"4834","10449634",0,1,0,0,0,0
"4835","10449640",0,2,0,0,0,0
"4836","10449643",0,1,0,0,0,0
"4837","10449647",0,2,0,0,0,0
"4838","10449651",0,8,8,4,0,12
"4839","10449667",0,5,0,0,0,0
"4840","10449670",0,6,0,0,0,0
"4841","10449723",0,1,0,0,0,0
"4842","10449728",0,4,2,1,0,3
"4843","10449732",0,1,0,0,0,0
"4844","10449747",0,4,7,1,0,8
"4845","10449835",0,8,10,9,2,21
"4846","10449920",0,5,4,8,0,12
"4847","10449959",0,10,5,7,5,17
"4848","10449965",0,3,3,0,0,3
"4849","10450005",0,4,0,0,0,0
"4850","10450056",0,5,2,8,0,10
"4851","10450067",0,1,1,0,0,1
"4852","10450077",0,5,5,0,0,5
"4853","10450078",0,5,2,0,0,2
"4854","10450097",0,4,1,1,0,2
"4855","10450120",1,6,1,2,0,3
"4856","10450130",0,4,1,0,0,1
"4857","10450226",0,4,2,1,0,3
"4858","10450254",0,4,2,0,0,2
"4859","10450262",0,8,5,8,1,14
"4860","10450267",0,4,0,0,0,0
"4861","10450369",0,1,0,0,0,0
"4862","10450381",0,4,5,1,0,6
"4863","10450392",0,4,0,0,0,0
"4864","10450424",0,3,0,1,0,1
"4865","10450536",0,7,3,1,0,4
"4866","10450537",0,4,1,0,0,1
"4867","10450546",0,1,0,0,0,0
"4868","10450556",0,3,4,3,0,7
"4869","10450589",0,2,1,0,0,1
"4870","10450647",0,4,2,1,0,3
"4871","10450659",0,4,1,1,0,2
"4872","10450665",0,1,0,1,0,1
"4873","10450678",0,4,13,1,0,14
"4874","10450690",0,4,0,1,0,1
"4875","10450696",0,2,0,0,0,0
"4876","10450747",0,5,5,0,1,6
"4877","10450760",0,3,1,0,0,1
"4878","10450767",0,3,5,2,0,7
"4879","10450806",0,4,1,1,0,2
"4880","10450824",0,1,0,0,0,0
"4881","10450913",0,6,1,0,0,1
"4882","10450917",0,3,0,0,0,0
"4883","10450928",0,3,0,0,0,0
"4884","10450929",0,4,2,2,0,4
"4885","10450956",1,5,3,2,3,8
"4886","10451035",0,5,1,2,0,3
"4887","10451069",0,7,5,6,0,11
"4888","10451076",0,5,8,3,0,11
"4889","10451103",0,5,13,4,0,17
"4890","10451138",0,1,0,0,0,0
"4891","10451149",0,1,0,0,0,0
"4892","10451174",0,4,0,3,0,3
"4893","10451188",0,2,0,1,0,1
"4894","10451222",0,4,2,1,0,3
"4895","10451233",0,1,1,0,0,1
"4896","10451239",0,4,0,2,0,2
"4897","10451304",0,2,0,0,0,0
"4898","10451333",0,3,2,3,0,5
"4899","10451340",0,10,9,8,2,19
"4900","10451346",0,2,0,0,0,0
"4901","10451373",0,6,4,4,0,8
"4902","10451387",0,7,8,1,0,9
"4903","10451402",0,5,0,2,0,2
"4904","10451410",0,6,2,2,0,4
"4905","10451415",0,3,0,0,0,0
"4906","10451471",0,1,1,0,0,1
"4907","10451472",0,2,0,0,0,0
"4908","10451479",0,2,0,0,0,0
"4909","10451480",0,3,0,0,0,0
"4910","10451640",0,2,0,0,0,0
"4911","10451666",0,2,0,0,0,0
"4912","10451675",0,1,0,0,0,0
"4913","10451679",0,1,1,2,0,3
"4914","10451692",0,1,0,2,0,2
"4915","10451715",0,4,2,0,0,2
"4916","10451756",0,2,0,0,0,0
"4917","10451856",0,7,9,8,1,18
"4918","10451868",0,8,21,4,0,25
"4919","10451870",0,6,1,1,0,2
"4920","10451882",0,4,3,1,0,4
"4921","10451918",0,5,1,2,0,3
"4922","10451939",0,1,1,0,0,1
"4923","10451955",0,4,5,2,0,7
"4924","10452007",0,4,3,0,0,3
"4925","10452053",0,4,2,0,0,2
"4926","10452064",0,1,1,0,0,1
"4927","10452097",0,2,0,0,0,0
"4928","10452101",0,1,0,0,0,0
"4929","10452174",0,2,0,0,0,0
"4930","10452241",0,4,1,0,0,1
"4931","10452258",0,1,0,0,0,0
"4932","10452284",0,4,1,1,0,2
"4933","10452286",0,4,2,1,0,3
"4934","10452288",0,8,3,1,1,5
"4935","10452315",0,1,0,0,0,0
"4936","10452334",0,1,0,0,0,0
"4937","10452364",0,3,2,2,0,4
"4938","10452393",0,9,13,6,0,19
"4939","10452408",0,2,1,3,0,4
"4940","10452424",0,3,2,0,0,2
"4941","10452428",0,5,3,1,0,4
"4942","10452462",0,3,0,0,0,0
"4943","10452497",0,3,2,1,0,3
"4944","10452540",0,1,0,0,0,0
"4945","10452542",0,1,0,0,0,0
"4946","10452582",0,4,0,0,0,0
"4947","10452583",0,4,1,0,0,1
"4948","10452593",0,6,1,1,0,2
"4949","10452594",0,3,0,0,0,0
"4950","10452628",0,4,0,0,0,0
"4951","10452629",0,4,6,6,0,12
"4952","10452677",0,5,9,5,0,14
"4953","10452690",0,7,8,7,1,16
"4954","10452704",0,7,7,4,0,11
"4955","10452784",0,5,2,5,0,7
"4956","10452864",0,1,0,2,0,2
"4957","10452890",0,7,3,9,2,14
"4958","10452913",0,1,1,0,0,1
"4959","10452927",0,7,5,3,0,8
"4960","10452951",0,1,0,0,0,0
"4961","10453030",0,1,0,0,0,0
"4962","10453046",0,5,1,1,0,2
"4963","10453069",0,1,0,0,0,0
"4964","10453072",0,5,2,0,0,2
"4965","10453076",1,3,4,0,0,4
"4966","10453104",0,1,0,0,0,0
"4967","10453113",0,3,0,0,0,0
"4968","10453125",0,1,0,0,0,0
"4969","10453144",0,4,1,0,0,1
"4970","10453195",0,7,10,3,0,13
"4971","10453196",0,2,0,2,0,2
"4972","10453197",0,3,0,0,0,0
"4973","10453199",0,6,2,1,0,3
"4974","10453202",0,9,8,7,1,16
"4975","10453205",0,2,1,0,0,1
"4976","10453208",0,7,5,6,0,11
"4977","10453212",0,3,1,0,0,1
"4978","10453216",0,5,0,0,0,0
"4979","10453222",0,4,0,2,0,2
"4980","10453239",0,4,2,0,0,2
"4981","10453242",0,3,1,0,0,1
"4982","10453288",0,1,0,0,0,0
"4983","10453296",0,5,3,3,0,6
"4984","10453300",0,3,4,2,0,6
"4985","10453323",0,1,0,0,0,0
"4986","10453394",0,3,3,3,0,6
"4987","10453445",0,2,0,0,0,0
"4988","10453448",0,3,0,0,0,0
"4989","10453462",0,4,0,0,0,0
"4990","10453470",0,6,5,4,0,9
"4991","10453522",0,4,3,0,0,3
"4992","10453542",0,4,4,0,0,4
"4993","10453560",0,2,1,1,0,2
"4994","10453603",0,2,0,0,0,0
"4995","10453614",0,5,4,2,0,6
"4996","10453622",0,2,1,0,0,1
"4997","10453624",0,1,2,1,0,3
"4998","10453640",0,2,0,0,0,0
"4999","10453652",0,3,3,1,0,4
"5000","10453677",0,3,0,1,0,1
"5001","10453681",0,2,0,0,0,0
"5002","10453688",0,9,6,5,1,12
"5003","10453689",0,4,3,0,0,3
"5004","10453704",0,2,0,0,0,0
"5005","10453719",0,1,0,0,0,0
"5006","10453726",0,3,1,1,0,2
"5007","10453764",0,3,0,0,0,0
"5008","10453772",0,5,4,4,0,8
"5009","10453816",0,4,3,1,0,4
"5010","10453825",0,1,0,0,0,0
"5011","10453833",0,3,1,0,0,1
"5012","10453834",0,2,0,0,0,0
"5013","10453837",0,3,6,0,0,6
"5014","10453838",0,4,0,0,0,0
"5015","10453873",0,8,4,4,0,8
"5016","10453962",0,7,9,5,0,14
"5017","10453980",0,4,1,1,0,2
"5018","10454015",0,3,4,4,0,8
"5019","10454024",0,1,0,0,0,0
"5020","10454029",0,4,1,3,0,4
"5021","10454102",0,7,10,13,3,26
"5022","10454105",0,3,3,0,0,3
"5023","10454144",0,1,0,0,0,0
"5024","10454149",0,3,1,3,0,4
"5025","10454160",0,2,1,0,0,1
"5026","10454163",0,4,0,1,0,1
"5027","10454167",0,4,0,4,0,4
"5028","10454259",0,4,1,0,0,1
"5029","10454262",0,11,4,11,7,22
"5030","10454277",0,4,0,0,0,0
"5031","10454283",0,2,3,1,0,4
"5032","10454289",0,1,0,0,0,0
"5033","10454299",0,1,0,0,0,0
"5034","10454373",0,2,0,0,0,0
"5035","10454400",0,1,0,0,0,0
"5036","10454428",0,2,2,0,0,2
"5037","10454673",0,2,1,1,0,2
"5038","10454704",0,4,1,0,0,1
"5039","10454710",0,4,4,0,0,4
"5040","10454789",0,4,5,5,0,10
"5041","10454914",0,4,6,3,0,9
"5042","10454918",0,1,0,0,0,0
"5043","10454940",0,3,0,0,0,0
"5044","10454945",0,3,1,0,0,1
"5045","10454992",0,1,2,3,0,5
"5046","10454998",0,5,4,0,0,4
"5047","10455028",0,4,1,1,0,2
"5048","10455031",0,2,1,0,0,1
"5049","10455033",0,4,2,0,0,2
"5050","10455060",0,1,0,0,0,0
"5051","10455082",0,4,0,0,0,0
"5052","10455116",0,7,8,5,1,14
"5053","10455143",0,1,0,0,0,0
"5054","10455162",0,4,9,2,0,11
"5055","10455179",0,2,0,0,0,0
"5056","10455236",0,5,1,4,0,5
"5057","10455281",0,4,8,0,0,8
"5058","10455290",0,6,1,1,0,2
"5059","10455324",0,3,4,2,0,6
"5060","10455327",0,4,8,2,0,10
"5061","10455331",0,4,1,0,0,1
"5062","10455412",0,6,12,3,0,15
"5063","10455433",0,8,7,6,2,15
"5064","10455447",0,1,0,0,0,0
"5065","10455496",0,1,0,0,0,0
"5066","10455499",0,4,0,1,0,1
"5067","10455500",0,6,7,7,1,15
"5068","10455612",0,2,0,0,0,0
"5069","10455613",0,1,0,0,0,0
"5070","10455616",0,1,0,0,0,0
"5071","10455634",0,4,1,1,0,2
"5072","10455673",0,1,0,0,0,0
"5073","10455709",0,6,4,5,0,9
"5074","10455736",0,3,2,0,0,2
"5075","10455781",0,1,0,0,0,0
"5076","10455802",0,4,4,1,0,5
"5077","10455842",0,3,0,0,0,0
"5078","10455890",0,1,0,0,0,0
"5079","10455892",0,6,10,3,0,13
"5080","10455925",0,2,0,0,0,0
"5081","10455935",1,5,0,1,0,1
"5082","10455937",1,5,2,1,0,3
"5083","10456031",0,6,5,2,2,9
"5084","10456032",0,5,5,1,0,6
"5085","10456086",0,1,0,0,0,0
"5086","10456104",0,2,1,0,0,1
"5087","10456266",0,8,7,5,2,14
"5088","10456287",0,4,2,0,0,2
"5089","10456438",0,4,0,0,0,0
"5090","10456475",0,3,0,0,0,0
"5091","10456486",0,7,3,3,0,6
"5092","10456496",0,4,3,2,1,6
"5093","10456497",0,3,3,0,0,3
"5094","10456537",0,1,1,0,0,1
"5095","10456540",0,4,2,3,0,5
"5096","10456567",0,5,4,0,0,4
"5097","10456572",0,2,2,0,0,2
"5098","10456605",0,7,5,2,1,8
"5099","10456624",0,5,4,0,0,4
"5100","10456629",0,6,9,2,0,11
"5101","10456657",0,4,1,1,0,2
"5102","10456693",0,3,0,0,0,0
"5103","10456700",0,4,5,1,0,6
"5104","10456701",0,5,0,0,0,0
"5105","10456738",0,8,5,13,4,22
"5106","10456743",0,1,0,0,0,0
"5107","10456833",0,3,0,0,0,0
"5108","10456835",0,2,0,0,0,0
"5109","10456852",0,4,0,0,0,0
"5110","10456856",0,2,0,0,0,0
"5111","10456858",0,3,0,0,0,0
"5112","10456917",0,6,3,1,0,4
"5113","10456958",0,5,5,2,0,7
"5114","10456979",0,8,7,6,2,15
"5115","10456981",0,4,1,0,0,1
"5116","10456984",0,2,0,0,0,0
"5117","10457012",0,5,5,3,0,8
"5118","10457127",0,3,5,1,0,6
"5119","10457154",0,2,1,3,1,5
"5120","10457229",0,4,10,0,0,10
"5121","10457234",0,2,2,1,0,3
"5122","10457282",0,5,1,3,0,4
"5123","10457304",0,4,6,2,0,8
"5124","10457340",0,4,0,0,0,0
"5125","10457419",0,4,7,0,0,7
"5126","10457431",1,3,1,0,0,1
"5127","10457460",0,7,1,2,0,3
"5128","10457465",0,5,4,0,0,4
"5129","10457523",0,5,3,1,0,4
"5130","10457571",0,1,0,0,0,0
"5131","10457603",0,5,4,6,0,10
"5132","10457628",0,5,5,0,0,5
"5133","10457657",0,1,0,0,0,0
"5134","10457667",0,1,1,0,0,1
"5135","10457706",0,5,5,3,0,8
"5136","10457739",0,3,0,0,0,0
"5137","10457740",0,1,0,0,0,0
"5138","10457799",0,4,4,0,0,4
"5139","10457809",1,4,4,0,0,4
"5140","10457900",0,6,2,2,0,4
"5141","10457911",0,5,4,2,0,6
"5142","10457912",0,4,6,1,0,7
"5143","10457920",0,1,0,0,0,0
"5144","10458128",0,4,0,0,0,0
"5145","10458136",0,4,3,2,0,5
"5146","10458157",0,2,0,2,0,2
"5147","10458172",0,5,7,0,0,7
"5148","10458178",0,5,7,2,0,9
"5149","10458183",0,3,0,0,0,0
"5150","10458188",0,1,0,0,0,0
"5151","10458213",0,4,2,1,0,3
"5152","10458270",0,7,11,5,0,16
"5153","10458277",0,4,0,0,0,0
"5154","10458307",0,3,0,0,0,0
"5155","10458332",0,4,6,1,0,7
"5156","10458360",0,3,0,0,0,0
"5157","10458361",0,4,5,8,0,13
"5158","10458375",0,3,0,0,0,0
"5159","10458393",0,1,0,0,0,0
"5160","10458418",0,1,0,0,0,0
"5161","10458422",0,5,3,5,0,8
"5162","10458459",0,4,1,0,0,1
"5163","10458462",0,3,2,2,0,4
"5164","10458469",0,2,3,0,0,3
"5165","10458485",0,2,0,0,0,0
"5166","10458487",0,2,1,0,0,1
"5167","10458488",0,4,2,3,0,5
"5168","10458489",0,2,0,0,0,0
"5169","10458491",1,5,8,2,0,10
"5170","10458496",0,2,0,1,0,1
"5171","10458528",0,2,0,1,0,1
"5172","10458557",0,6,0,0,0,0
"5173","10458582",0,4,2,4,0,6
"5174","10458586",0,4,0,0,0,0
"5175","10458636",0,4,6,3,0,9
"5176","10458648",0,4,8,8,0,16
"5177","10458666",0,1,0,0,0,0
"5178","10458679",0,3,0,0,0,0
"5179","10458757",0,3,0,1,0,1
"5180","10458772",0,5,1,4,1,6
"5181","10458841",0,5,6,1,0,7
"5182","10458850",0,2,0,0,0,0
"5183","10458899",0,3,3,1,0,4
"5184","10458921",0,4,4,2,0,6
"5185","10458922",0,2,0,0,0,0
"5186","10458932",0,2,0,0,0,0
"5187","10458943",1,2,0,0,0,0
"5188","10459012",0,3,4,1,0,5
"5189","10459014",0,5,8,2,0,10
"5190","10459022",0,4,4,1,0,5
"5191","10459029",0,1,0,0,0,0
"5192","10459044",0,4,1,1,0,2
"5193","10459046",0,3,3,0,0,3
"5194","10459047",0,4,0,0,0,0
"5195","10459051",0,4,1,0,0,1
"5196","10459077",0,5,2,0,0,2
"5197","10459141",0,6,8,2,0,10
"5198","10459157",0,1,0,0,0,0
"5199","10459184",0,1,0,0,0,0
"5200","10459186",0,2,0,0,0,0
"5201","10459189",0,5,7,5,0,12
"5202","10459293",0,3,3,0,0,3
"5203","10459355",0,4,1,2,0,3
"5204","10459396",0,7,9,5,0,14
"5205","10459455",0,3,0,0,0,0
"5206","10459464",0,6,0,0,0,0
"5207","10459492",0,4,6,1,0,7
"5208","10459498",0,4,4,1,0,5
"5209","10459502",0,1,0,0,0,0
"5210","10459514",1,4,1,1,0,2
"5211","10459523",1,4,0,3,0,3
"5212","10459531",0,1,0,0,0,0
"5213","10459571",0,6,0,0,0,0
"5214","10459577",0,8,9,5,2,16
"5215","10459580",0,2,2,0,0,2
"5216","10459582",0,1,0,0,0,0
"5217","10459583",0,1,0,0,0,0
"5218","10459650",0,5,7,3,0,10
"5219","10459657",1,2,2,0,0,2
"5220","10459663",1,3,0,0,0,0
"5221","10459691",0,6,3,3,0,6
"5222","10459696",0,6,3,2,1,6
"5223","10459708",0,1,0,2,0,2
"5224","10459748",0,4,2,4,0,6
"5225","10459804",0,2,0,1,0,1
"5226","10459858",0,5,5,1,0,6
"5227","10459873",0,2,0,0,0,0
"5228","10459920",0,1,0,0,0,0
"5229","10459946",0,5,0,3,1,4
"5230","10459956",0,5,1,0,0,1
"5231","10459969",0,1,0,0,0,0
"5232","10459996",0,4,0,3,0,3
"5233","10460004",0,4,1,2,0,3
"5234","10460010",0,7,5,7,0,12
"5235","10460040",0,4,0,0,0,0
"5236","10460080",0,4,1,3,0,4
"5237","10460107",0,6,0,4,0,4
"5238","10460141",0,4,3,1,1,5
"5239","10460234",1,4,1,5,0,6
"5240","10460247",0,3,2,2,0,4
"5241","10460251",1,5,2,3,0,5
"5242","10460291",0,6,0,0,0,0
"5243","10460377",0,1,0,0,0,0
"5244","10460432",0,4,0,0,0,0
"5245","10460465",0,6,5,3,0,8
"5246","10460481",0,5,1,0,0,1
"5247","10460482",0,4,0,0,0,0
"5248","10460497",0,1,0,0,0,0
"5249","10460502",0,4,1,0,0,1
"5250","10460543",0,5,6,3,1,10
"5251","10460565",0,2,0,0,0,0
"5252","10460568",0,3,4,0,0,4
"5253","10460586",0,3,0,0,0,0
"5254","10460588",0,1,0,0,0,0
"5255","10460618",0,6,1,1,0,2
"5256","10460631",0,1,0,0,0,0
"5257","10460662",0,4,3,4,0,7
"5258","10460663",0,5,4,1,0,5
"5259","10460667",0,6,6,5,0,11
"5260","10460681",0,5,8,2,1,11
"5261","10460708",0,4,7,1,0,8
"5262","10460710",0,6,1,4,1,6
"5263","10460711",0,5,6,10,0,16
"5264","10460715",0,4,4,4,1,9
"5265","10460758",0,3,1,2,0,3
"5266","10460792",0,3,0,0,0,0
"5267","10460794",1,4,0,0,0,0
"5268","10460851",0,7,4,12,0,16
"5269","10460853",0,5,0,0,0,0
"5270","10460862",0,3,0,0,0,0
"5271","10460893",1,4,2,2,0,4
"5272","10460939",0,8,8,13,1,22
"5273","10460984",0,1,3,0,0,3
"5274","10460987",0,5,3,2,0,5
"5275","10461062",0,1,0,0,0,0
"5276","10461088",0,3,3,2,0,5
"5277","10461172",0,4,0,2,0,2
"5278","10461209",0,6,7,1,0,8
"5279","10461221",0,1,0,0,0,0
"5280","10461230",0,4,0,0,0,0
"5281","10461233",0,4,1,0,0,1
"5282","10461239",0,6,1,11,0,12
"5283","10461244",0,4,0,0,0,0
"5284","10461256",0,5,6,8,0,14
"5285","10461275",0,1,0,0,0,0
"5286","10461285",0,7,7,5,1,13
"5287","10461302",0,1,2,0,0,2
"5288","10461305",0,8,8,6,1,15
"5289","10461307",0,5,1,6,0,7
"5290","10461322",0,6,7,4,0,11
"5291","10461331",0,4,0,0,0,0
"5292","10461350",0,8,10,16,0,26
"5293","10461379",0,6,3,2,0,5
"5294","10461380",0,6,5,2,0,7
"5295","10461383",0,3,0,1,0,1
"5296","10461399",1,5,3,2,1,6
"5297","10461412",0,3,1,0,0,1
"5298","10461434",0,3,2,1,0,3
"5299","10461445",0,6,8,3,0,11
"5300","10461471",0,5,4,7,0,11
"5301","10461487",0,5,0,3,0,3
"5302","10461506",0,7,3,0,0,3
"5303","10461514",0,5,2,1,0,3
"5304","10461535",0,2,0,0,0,0
"5305","10461543",0,4,3,0,0,3
"5306","10461560",0,3,0,1,0,1
"5307","10461621",0,5,3,2,0,5
"5308","10461649",0,5,5,0,0,5
"5309","10461750",0,4,4,1,0,5
"5310","10461765",0,3,1,0,0,1
"5311","10461767",0,3,2,0,0,2
"5312","10461782",0,4,0,0,0,0
"5313","10461789",0,4,2,1,0,3
"5314","10462077",0,3,1,0,0,1
"5315","10462130",0,4,1,2,0,3
"5316","10462218",0,1,0,0,0,0
"5317","10462221",0,2,2,1,0,3
"5318","10462222",0,2,0,1,1,2
"5319","10462392",0,1,0,0,0,0
"5320","10462394",0,5,8,4,0,12
"5321","10462417",0,4,5,1,0,6
"5322","10462491",0,5,3,0,1,4
"5323","10462558",0,5,0,0,0,0
"5324","10462640",0,1,0,0,0,0
"5325","10462662",0,4,1,0,0,1
"5326","10462721",0,7,9,3,0,12
"5327","10462733",0,4,1,0,0,1
"5328","10462803",0,4,0,2,0,2
"5329","10462863",0,4,3,0,0,3
"5330","10463033",0,1,0,0,0,0
"5331","10463130",0,4,3,0,0,3
"5332","10463139",0,2,2,0,0,2
"5333","10463146",0,5,1,1,0,2
"5334","10463158",0,7,5,8,0,13
"5335","10463201",0,6,5,1,0,6
"5336","10463235",0,12,8,9,8,25
"5337","10463241",0,1,1,0,0,1
"5338","10463249",0,5,6,2,0,8
"5339","10463296",0,3,0,0,0,0
"5340","10463371",0,2,2,0,0,2
"5341","10463404",0,3,0,0,0,0
"5342","10463444",0,2,2,1,0,3
"5343","10463481",0,4,1,0,0,1
"5344","10463499",0,3,4,1,0,5
"5345","10463502",0,1,2,0,0,2
"5346","10463538",0,6,1,0,0,1
"5347","10463560",0,5,10,4,0,14
"5348","10463569",0,1,0,0,0,0
"5349","10463633",0,5,1,2,0,3
"5350","10463704",0,5,2,2,0,4
"5351","10463788",0,4,0,4,0,4
"5352","10463909",0,3,4,3,0,7
"5353","10463955",0,5,0,0,0,0
"5354","10463977",0,5,1,0,0,1
"5355","10463984",0,3,2,0,0,2
"5356","10463993",0,6,7,8,0,15
"5357","10464019",0,6,0,0,0,0
"5358","10464060",0,5,4,0,0,4
"5359","10464069",0,4,0,1,0,1
"5360","10464086",0,4,0,0,0,0
"5361","10464108",0,2,0,0,0,0
"5362","10464268",0,8,10,10,3,23
"5363","10464273",0,1,0,0,0,0
"5364","10464283",0,4,2,0,0,2
"5365","10464345",0,3,1,2,0,3
"5366","10464367",0,10,8,16,4,28
"5367","10464375",0,3,0,0,0,0
"5368","10464424",0,1,2,0,0,2
"5369","10464528",0,2,0,2,0,2
"5370","10464629",0,5,4,3,0,7
"5371","10464651",0,4,1,1,0,2
"5372","10464676",0,2,0,0,0,0
"5373","10464682",0,2,0,0,0,0
"5374","10464701",0,5,13,3,0,16
"5375","10464730",0,3,2,0,0,2
"5376","10464736",0,5,3,3,0,6
"5377","10464752",0,4,0,0,0,0
"5378","10464799",0,4,0,0,0,0
"5379","10464953",0,1,0,0,0,0
"5380","10465052",0,6,6,3,0,9
"5381","10465072",0,6,2,4,3,9
"5382","10465183",0,3,3,1,0,4
"5383","10465244",0,1,0,0,0,0
"5384","10465264",0,2,0,1,0,1
"5385","10465267",0,2,0,1,0,1
"5386","10465281",0,1,0,0,0,0
"5387","10465294",0,1,2,0,0,2
"5388","10465295",0,5,9,6,0,15
"5389","10465374",0,3,2,1,0,3
"5390","10465389",0,6,0,3,0,3
"5391","10465391",0,3,4,1,0,5
"5392","10465399",0,4,2,1,0,3
"5393","10465429",0,3,2,2,0,4
"5394","10465614",0,4,5,1,0,6
"5395","10465626",0,2,0,0,0,0
"5396","10465632",0,2,0,0,0,0
"5397","10465836",0,4,1,1,0,2
"5398","10465880",0,3,1,0,0,1
"5399","10465900",0,6,3,1,0,4
"5400","10466003",0,4,0,1,0,1
"5401","10466051",0,3,2,1,0,3
"5402","10466099",0,1,0,0,0,0
"5403","10466106",0,5,3,4,0,7
"5404","10466117",0,2,0,0,0,0
"5405","10466125",0,2,0,0,0,0
"5406","10466128",0,4,2,0,0,2
"5407","10466130",0,5,5,0,0,5
"5408","10466133",0,2,2,2,0,4
"5409","10466139",0,3,1,0,0,1
"5410","10466142",0,1,0,0,0,0
"5411","10466206",0,4,4,3,0,7
"5412","10466215",0,1,0,0,0,0
"5413","10466233",0,6,1,1,0,2
"5414","10466347",0,2,0,0,0,0
"5415","10466420",0,1,0,0,0,0
"5416","10466432",0,5,10,5,0,15
"5417","10466437",0,4,0,0,0,0
"5418","10466439",0,1,0,0,0,0
"5419","10466485",0,2,2,1,0,3
"5420","10466519",0,2,4,0,0,4
"5421","10466559",0,4,6,3,0,9
"5422","10466567",0,3,3,2,0,5
"5423","10466609",0,4,2,2,0,4
"5424","10466618",0,2,2,2,0,4
"5425","10466627",0,4,3,1,0,4
"5426","10466671",0,1,0,0,0,0
"5427","10466697",0,3,2,6,0,8
"5428","10466701",0,2,0,0,0,0
"5429","10466744",0,6,3,4,0,7
"5430","10466746",0,4,2,2,0,4
"5431","10466751",0,5,3,4,0,7
"5432","10466788",0,2,3,0,0,3
"5433","10466794",0,1,0,0,0,0
"5434","10466799",0,1,0,0,0,0
"5435","10466815",0,6,4,4,0,8
"5436","10466868",0,1,0,0,0,0
"5437","10466899",0,2,0,0,0,0
"5438","10467015",0,2,0,1,0,1
"5439","10467094",0,3,0,0,0,0
"5440","10467183",0,1,0,0,0,0
"5441","10467187",0,2,0,1,0,1
"5442","10467195",0,6,4,3,0,7
"5443","10467273",0,1,0,0,0,0
"5444","10467343",0,4,3,6,0,9
"5445","10467346",0,1,0,0,0,0
"5446","10467394",0,3,2,1,0,3
"5447","10467400",0,4,1,0,0,1
"5448","10467402",0,4,0,1,0,1
"5449","10467448",0,3,1,0,0,1
"5450","10467495",0,5,6,3,1,10
"5451","10467498",0,6,10,0,0,10
"5452","10467512",0,2,1,1,0,2
"5453","10467526",0,2,0,1,0,1
"5454","10467587",0,3,3,0,0,3
"5455","10467591",0,1,1,0,0,1
"5456","10467596",0,4,7,2,0,9
"5457","10467617",0,3,0,0,0,0
"5458","10467649",0,6,5,3,0,8
"5459","10467734",0,4,1,1,0,2
"5460","10467771",0,1,0,0,0,0
"5461","10467776",0,3,0,0,0,0
"5462","10467779",0,6,3,2,0,5
"5463","10467878",0,4,2,0,0,2
"5464","10467889",0,3,0,0,0,0
"5465","10467931",0,2,2,0,0,2
"5466","10467934",0,3,2,0,0,2
"5467","10467960",0,3,0,0,0,0
"5468","10468049",0,2,1,0,0,1
"5469","10468075",0,9,5,5,3,13
"5470","10468081",0,4,1,0,0,1
"5471","10468090",0,1,1,0,0,1
"5472","10468100",0,4,0,0,0,0
"5473","10468110",0,2,1,0,0,1
"5474","10468132",0,2,0,0,0,0
"5475","10468133",0,2,2,1,0,3
"5476","10468180",0,1,0,1,0,1
"5477","10468264",0,3,2,2,0,4
"5478","10468265",0,2,0,2,0,2
"5479","10468289",0,1,0,0,0,0
"5480","10468307",0,1,0,0,0,0
"5481","10468311",0,4,0,0,0,0
"5482","10468324",0,2,0,0,0,0
"5483","10468327",0,1,0,0,0,0
"5484","10468577",0,6,8,5,1,14
"5485","10468619",0,4,2,1,0,3
"5486","10468651",0,5,0,1,0,1
"5487","10468712",0,2,0,0,0,0
"5488","10468713",0,3,1,0,0,1
"5489","10468770",0,6,7,4,1,12
"5490","10468897",0,3,1,0,0,1
"5491","10468931",1,3,2,1,0,3
"5492","10468961",0,2,3,1,0,4
"5493","10469053",0,3,1,1,0,2
"5494","10469125",0,4,0,0,0,0
"5495","10469140",0,5,4,2,0,6
"5496","10469142",0,1,1,0,0,1
"5497","10469146",0,4,2,0,0,2
"5498","10469153",0,5,4,1,0,5
"5499","10469156",0,4,0,0,0,0
"5500","10469181",0,2,1,2,0,3
"5501","10469193",0,5,0,0,0,0
"5502","10469198",0,4,4,2,0,6
"5503","10469351",0,1,0,0,0,0
"5504","10469441",0,3,4,3,1,8
"5505","10469448",0,1,0,0,0,0
"5506","10469449",0,5,0,0,0,0
"5507","10469463",0,5,6,3,0,9
"5508","10469603",0,2,2,1,0,3
"5509","10469621",0,5,1,0,1,2
"5510","10469631",0,6,4,6,0,10
"5511","10469642",0,5,4,1,0,5
"5512","10469697",0,7,8,6,2,16
"5513","10469883",0,4,7,7,2,16
"5514","10469907",0,2,0,0,0,0
"5515","10469971",0,5,6,1,0,7
"5516","10470129",0,5,4,0,0,4
"5517","10470191",0,6,6,8,0,14
"5518","10470244",0,3,0,0,0,0
"5519","10470245",0,6,6,1,0,7
"5520","10470282",0,3,2,0,0,2
"5521","10470457",0,3,0,0,0,0
"5522","10470481",0,1,0,1,0,1
"5523","10470486",0,4,0,0,0,0
"5524","10470524",0,3,0,0,0,0
"5525","10470532",0,4,0,3,1,4
"5526","10470566",0,8,6,14,0,20
"5527","10470606",0,3,1,1,0,2
"5528","10470629",0,6,4,1,0,5
"5529","10470677",0,1,0,0,0,0
"5530","10470713",0,3,0,0,0,0
"5531","10470727",0,4,0,2,0,2
"5532","10470731",0,3,0,0,0,0
"5533","10470740",0,3,1,2,0,3
"5534","10470964",0,4,1,0,0,1
"5535","10470996",0,4,4,0,0,4
"5536","10471078",0,6,1,2,0,3
"5537","10471186",0,5,10,12,0,22
"5538","10471187",0,4,0,0,0,0
"5539","10471288",0,2,0,1,0,1
"5540","10471290",0,5,4,1,0,5
"5541","10471411",0,8,9,1,0,10
"5542","10471552",0,4,6,9,1,16
"5543","10471602",0,3,2,0,0,2
"5544","10471640",0,4,5,2,0,7
"5545","10471649",0,2,0,0,0,0
"5546","10471677",0,4,4,2,0,6
"5547","10471765",0,11,13,7,3,23
"5548","10471871",0,1,0,0,0,0
"5549","10471875",0,4,1,0,0,1
"5550","10471881",0,2,2,0,0,2
"5551","10471906",0,4,1,0,0,1
"5552","10471931",0,1,0,0,0,0
"5553","10472020",0,4,6,5,0,11
"5554","10472041",0,7,10,3,1,14
"5555","10472044",0,1,1,0,0,1
"5556","10472046",0,4,6,3,0,9
"5557","10472165",0,3,1,0,0,1
"5558","10472198",0,3,5,1,0,6
"5559","10472349",0,3,0,2,0,2
"5560","10472354",0,2,3,2,0,5
"5561","10472389",0,2,1,0,0,1
"5562","10472413",0,5,2,5,0,7
"5563","10472424",0,4,2,0,0,2
"5564","10472471",0,3,3,0,0,3
"5565","10472489",0,5,1,4,0,5
"5566","10472492",0,7,6,10,3,19
"5567","10472590",0,2,3,5,1,9
"5568","10472630",0,5,6,10,2,18
"5569","10472677",0,6,2,2,1,5
"5570","10472689",0,8,13,7,2,22
"5571","10472745",0,4,1,0,0,1
"5572","10472755",0,2,0,1,0,1
"5573","10472756",0,1,0,0,0,0
"5574","10472788",0,1,1,0,0,1
"5575","10472818",0,4,2,1,0,3
"5576","10472835",1,4,0,0,0,0
"5577","10472843",0,4,0,0,0,0
"5578","10472939",0,3,1,0,0,1
"5579","10473011",0,2,4,1,0,5
"5580","10473090",0,4,1,0,0,1
"5581","10473110",0,4,0,1,0,1
"5582","10473217",0,3,1,2,1,4
"5583","10473253",0,5,7,4,1,12
"5584","10473263",0,4,0,0,0,0
"5585","10473276",0,5,0,0,0,0
"5586","10473285",0,6,1,0,0,1
"5587","10473374",0,6,4,0,0,4
"5588","10473443",0,5,5,4,1,10
"5589","10473454",0,6,6,0,0,6
"5590","10473460",0,1,0,0,0,0
"5591","10473463",0,4,4,0,0,4
"5592","10473504",0,2,2,0,0,2
"5593","10473518",0,2,0,1,0,1
"5594","10473526",0,3,0,1,0,1
"5595","10473541",0,3,2,2,0,4
"5596","10473548",0,5,0,1,0,1
"5597","10473559",0,2,1,0,0,1
"5598","10473567",0,4,0,1,0,1
"5599","10473750",0,5,13,4,0,17
"5600","10473856",0,2,0,0,0,0
"5601","10473869",1,5,6,7,0,13
"5602","10473876",0,5,1,0,0,1
"5603","10473890",0,7,13,10,0,23
"5604","10473933",0,1,0,0,0,0
"5605","10473937",0,7,11,4,0,15
"5606","10474025",0,2,0,0,0,0
"5607","10474029",0,4,6,3,0,9
"5608","10474073",0,7,0,0,0,0
"5609","10474078",0,7,10,6,2,18
"5610","10474115",0,1,1,0,0,1
"5611","10474140",0,6,7,2,0,9
"5612","10474149",0,4,1,4,0,5
"5613","10474151",1,4,0,0,0,0
"5614","10474154",0,7,8,2,1,11
"5615","10474160",0,6,1,1,0,2
"5616","10474169",0,2,0,0,0,0
"5617","10474323",0,3,0,0,0,0
"5618","10474466",0,3,0,0,0,0
"5619","10474540",0,2,0,0,0,0
"5620","10474564",0,4,0,0,0,0
"5621","10474567",0,3,0,0,0,0
"5622","10474582",0,8,7,6,1,14
"5623","10474584",0,4,0,0,0,0
"5624","10474730",0,3,2,1,0,3
"5625","10474771",0,1,0,0,0,0
"5626","10474803",0,4,1,0,0,1
"5627","10474804",0,1,0,0,0,0
"5628","10474913",0,4,0,1,0,1
"5629","10474918",0,5,0,1,0,1
"5630","10475008",0,4,1,3,0,4
"5631","10475010",0,2,0,0,0,0
"5632","10475017",0,4,1,0,0,1
"5633","10475038",0,4,0,2,0,2
"5634","10475041",0,8,9,13,1,23
"5635","10475061",0,3,0,0,0,0
"5636","10475099",0,2,0,0,0,0
"5637","10475102",0,4,0,0,0,0
"5638","10475113",0,1,0,0,0,0
"5639","10475116",1,4,5,3,0,8
"5640","10475127",0,5,1,0,0,1
"5641","10475165",0,4,4,2,0,6
"5642","10475167",0,3,3,0,0,3
"5643","10475184",0,4,4,0,0,4
"5644","10475186",0,4,0,0,0,0
"5645","10475219",0,4,0,0,0,0
"5646","10475237",0,2,0,0,0,0
"5647","10475238",0,3,2,0,0,2
"5648","10475245",0,4,10,1,0,11
"5649","10475250",0,3,9,13,0,22
"5650","10475296",1,2,0,2,0,2
"5651","10475326",0,6,13,4,0,17
"5652","10475419",0,3,2,0,0,2
"5653","10475456",0,4,2,1,0,3
"5654","10475465",0,1,0,0,0,0
"5655","10475472",0,2,2,3,0,5
"5656","10475478",0,4,2,1,0,3
"5657","10475487",0,2,0,0,0,0
"5658","10475500",0,3,0,0,0,0
"5659","10475508",0,4,0,0,0,0
"5660","10475515",0,6,1,1,0,2
"5661","10475548",0,1,0,0,0,0
"5662","10475553",0,4,0,0,0,0
"5663","10475554",0,4,4,1,0,5
"5664","10475557",0,4,0,0,0,0
"5665","10475562",0,3,1,0,0,1
"5666","10475563",0,1,0,0,0,0
"5667","10475598",0,1,1,0,0,1
"5668","10475638",0,8,10,6,0,16
"5669","10475639",0,3,1,3,0,4
"5670","10475648",0,4,0,0,0,0
"5671","10475654",0,5,5,0,0,5
"5672","10475655",0,4,1,3,0,4
"5673","10475680",0,5,1,3,0,4
"5674","10475705",0,2,0,0,0,0
"5675","10475713",0,4,1,0,0,1
"5676","10475725",0,3,0,0,0,0
"5677","10475734",0,7,9,4,0,13
"5678","10475751",0,6,6,3,0,9
"5679","10475762",0,2,4,0,0,4
"5680","10475785",0,4,0,0,0,0
"5681","10475797",0,4,4,2,0,6
"5682","10475803",0,5,2,2,0,4
"5683","10475808",0,1,0,0,0,0
"5684","10475817",1,3,1,0,0,1
"5685","10475855",0,1,0,0,0,0
"5686","10475989",0,3,1,2,0,3
"5687","10475992",0,4,4,2,0,6
"5688","10475993",0,2,0,0,0,0
"5689","10476014",0,3,1,0,0,1
"5690","10476020",0,5,3,1,1,5
"5691","10476042",0,2,2,0,0,2
"5692","10476045",0,4,8,2,0,10
"5693","10476061",0,1,0,0,0,0
"5694","10476096",0,6,8,7,3,18
"5695","10476099",0,2,0,0,0,0
"5696","10476107",0,1,0,0,0,0
"5697","10476110",0,7,3,2,1,6
"5698","10476123",0,2,0,0,0,0
"5699","10476124",0,1,0,0,0,0
"5700","10476129",0,2,0,0,0,0
"5701","10476136",0,1,0,0,0,0
"5702","10476137",0,2,0,0,0,0
"5703","10476140",0,4,0,0,0,0
"5704","10476163",0,3,0,2,0,2
"5705","10476203",0,2,2,1,0,3
"5706","10476226",0,7,4,5,0,9
"5707","10476240",0,2,0,0,0,0
"5708","10476243",0,1,0,0,0,0
"5709","10476246",0,5,8,2,0,10
"5710","10476263",0,3,3,1,1,5
"5711","10476344",0,2,1,0,0,1
"5712","10476356",0,5,1,1,0,2
"5713","10476364",0,6,6,2,0,8
"5714","10476377",0,1,0,0,0,0
"5715","10476382",0,1,0,0,0,0
"5716","10476391",0,4,0,1,0,1
"5717","10476403",0,3,2,3,0,5
"5718","10476406",0,1,1,0,0,1
"5719","10476438",0,1,0,0,0,0
"5720","10476446",0,1,0,0,0,0
"5721","10476505",0,4,4,2,0,6
"5722","10476510",0,2,0,3,0,3
"5723","10476539",0,7,7,14,2,23
"5724","10476781",0,5,6,1,2,9
"5725","10476795",0,3,1,0,0,1
"5726","10476803",0,6,4,3,0,7
"5727","10476849",0,3,4,2,0,6
"5728","10476871",0,3,1,0,0,1
"5729","10476952",0,3,2,1,0,3
"5730","10476953",0,4,7,1,0,8
"5731","10476979",0,3,2,3,0,5
"5732","10477013",0,5,4,5,0,9
"5733","10477071",0,4,0,0,0,0
"5734","10477121",0,3,0,0,0,0
"5735","10477163",0,6,4,2,0,6
"5736","10477203",0,4,5,0,0,5
"5737","10477243",0,4,3,0,0,3
"5738","10477321",0,5,0,0,0,0
"5739","10477364",0,4,1,0,0,1
"5740","10477390",0,3,2,0,0,2
"5741","10477432",0,7,5,9,2,16
"5742","10477448",0,1,0,0,0,0
"5743","10477465",0,2,1,0,0,1
"5744","10477466",0,3,0,0,0,0
"5745","10477499",0,4,1,0,0,1
"5746","10477503",0,1,0,0,0,0
"5747","10477525",0,2,2,0,0,2
"5748","10477590",0,6,3,6,0,9
"5749","10477635",0,1,1,1,0,2
"5750","10477640",0,3,0,0,0,0
"5751","10477642",0,4,0,0,0,0
"5752","10477644",0,4,1,0,0,1
"5753","10477648",0,2,0,0,0,0
"5754","10477657",0,1,0,0,0,0
"5755","10477658",0,4,3,0,0,3
"5756","10477691",0,4,0,0,0,0
"5757","10477703",0,7,9,3,1,13
"5758","10477706",0,4,1,0,0,1
"5759","10477722",0,5,1,7,1,9
"5760","10477723",0,2,2,1,0,3
"5761","10477727",0,3,5,3,0,8
"5762","10477730",0,6,16,5,0,21
"5763","10477741",0,1,0,0,0,0
"5764","10477769",0,5,0,3,0,3
"5765","10477781",0,4,1,0,0,1
"5766","10477823",0,2,0,0,0,0
"5767","10477824",0,2,0,0,0,0
"5768","10477888",0,5,9,2,0,11
"5769","10478001",0,2,2,4,0,6
"5770","10478011",0,2,2,0,0,2
"5771","10478012",0,5,3,2,0,5
"5772","10478016",0,5,4,2,0,6
"5773","10478034",0,4,0,1,0,1
"5774","10478035",0,4,2,3,1,6
"5775","10478038",0,2,0,1,0,1
"5776","10478091",0,4,1,0,0,1
"5777","10478094",0,3,0,0,0,0
"5778","10478109",0,5,0,1,2,3
"5779","10478123",0,4,5,0,0,5
"5780","10478130",0,2,0,0,0,0
"5781","10478148",0,7,5,3,0,8
"5782","10478150",0,7,3,5,0,8
"5783","10478155",0,6,5,8,1,14
"5784","10478218",0,3,0,1,0,1
"5785","10478219",0,2,0,0,0,0
"5786","10478222",0,4,5,2,0,7
"5787","10478240",0,5,3,6,1,10
"5788","10478270",0,4,0,3,0,3
"5789","10478304",0,8,10,3,0,13
"5790","10478328",0,5,1,1,0,2
"5791","10478370",0,5,2,3,1,6
"5792","10478396",0,3,4,4,0,8
"5793","10478504",0,1,0,0,0,0
"5794","10478576",0,4,2,3,0,5
"5795","10478588",0,4,0,0,0,0
"5796","10478598",0,1,0,0,0,0
"5797","10478633",0,2,0,0,0,0
"5798","10478654",0,2,0,0,0,0
"5799","10478665",0,4,3,2,0,5
"5800","10478688",0,1,0,0,0,0
"5801","10478714",0,2,0,0,0,0
"5802","10478721",0,3,0,0,0,0
"5803","10478737",0,5,0,3,0,3
"5804","10478758",0,5,5,1,0,6
"5805","10478760",0,4,0,0,0,0
"5806","10478791",0,4,3,0,0,3
"5807","10478815",0,3,0,1,0,1
"5808","10478826",0,10,15,13,0,28
"5809","10478844",0,1,0,0,0,0
"5810","10478846",0,3,0,0,0,0
"5811","10478849",0,6,3,4,2,9
"5812","10478858",0,10,2,9,1,12
"5813","10478917",0,4,5,3,0,8
"5814","10478922",0,4,0,1,0,1
"5815","10478949",0,4,0,0,0,0
"5816","10479028",0,1,0,0,0,0
"5817","10479030",0,5,3,1,0,4
"5818","10479043",0,4,2,1,0,3
"5819","10479078",0,4,0,0,0,0
"5820","10479086",0,6,5,5,0,10
"5821","10479141",0,4,2,2,1,5
"5822","10479144",0,3,1,1,0,2
"5823","10479160",0,5,8,7,1,16
"5824","10479173",0,4,0,0,0,0
"5825","10479222",0,2,0,0,0,0
"5826","10479226",0,2,1,0,0,1
"5827","10479459",0,3,0,0,0,0
"5828","10479466",0,5,0,0,0,0
"5829","10479503",0,1,1,0,0,1
"5830","10479506",0,6,9,4,0,13
"5831","10479516",0,3,1,0,0,1
"5832","10479526",0,3,0,0,0,0
"5833","10479528",0,6,0,0,0,0
"5834","10479532",0,4,1,3,1,5
"5835","10479543",1,6,5,2,0,7
"5836","10479578",0,3,0,0,0,0
"5837","10479608",0,2,2,0,0,2
"5838","10479643",0,6,5,2,0,7
"5839","10479683",0,1,2,2,0,4
"5840","10479693",0,8,2,3,0,5
"5841","10479695",0,6,0,1,1,2
"5842","10479696",1,4,0,0,0,0
"5843","10479768",0,5,1,2,1,4
"5844","10479786",0,7,8,7,0,15
"5845","10479787",0,1,0,0,0,0
"5846","10479804",0,4,2,4,0,6
"5847","10479871",0,3,3,0,0,3
"5848","10479883",0,3,1,0,0,1
"5849","10479892",0,1,1,0,0,1
"5850","10479913",0,7,2,0,0,2
"5851","10479914",0,7,5,3,0,8
"5852","10480002",0,4,0,0,0,0
"5853","10480007",0,3,0,0,0,0
"5854","10480018",0,4,0,0,0,0
"5855","10480019",0,4,3,1,0,4
"5856","10480049",1,4,2,2,0,4
"5857","10480073",0,1,1,0,0,1
"5858","10480076",0,3,2,3,0,5
"5859","10480106",0,4,2,0,0,2
"5860","10480115",0,2,2,0,0,2
"5861","10480138",0,1,0,0,0,0
"5862","10480174",0,5,4,6,0,10
"5863","10480175",0,9,7,3,3,13
"5864","10480182",0,4,4,9,0,13
"5865","10480241",0,2,0,1,0,1
"5866","10480269",0,2,1,0,0,1
"5867","10480305",0,2,0,1,0,1
"5868","10480309",0,4,0,0,0,0
"5869","10480326",0,5,2,1,0,3
"5870","10480372",0,6,6,3,0,9
"5871","10480428",0,2,0,0,0,0
"5872","10480490",0,2,0,0,0,0
"5873","10480515",0,1,0,0,0,0
"5874","10480530",0,4,5,0,0,5
"5875","10480531",0,4,2,0,1,3
"5876","10480538",0,2,0,2,1,3
"5877","10480655",0,4,0,0,0,0
"5878","10480674",0,5,6,0,0,6
"5879","10480689",0,1,0,0,0,0
"5880","10480704",0,7,9,4,1,14
"5881","10480722",0,8,11,6,0,17
"5882","10480724",0,4,1,2,0,3
"5883","10480745",0,4,5,0,0,5
"5884","10480752",0,7,5,3,0,8
"5885","10480755",0,3,0,0,0,0
"5886","10480845",0,4,0,0,0,0
"5887","10480859",0,3,4,2,0,6
"5888","10480868",0,6,3,3,0,6
"5889","10480872",0,2,0,0,0,0
"5890","10480917",0,3,0,0,0,0
"5891","10480974",0,4,1,2,0,3
"5892","10480988",0,1,0,0,0,0
"5893","10481009",1,6,2,3,0,5
"5894","10481082",0,3,2,0,0,2
"5895","10481106",0,2,0,0,0,0
"5896","10481211",0,2,0,0,0,0
"5897","10481228",0,4,1,0,0,1
"5898","10481283",0,6,0,3,0,3
"5899","10481321",0,7,11,4,0,15
"5900","10481323",0,1,0,0,0,0
"5901","10481332",0,1,0,0,0,0
"5902","10481333",0,4,6,6,0,12
"5903","10481346",0,10,5,7,4,16
"5904","10481357",0,3,3,0,0,3
"5905","10481363",0,6,7,4,0,11
"5906","10481364",0,2,0,0,0,0
"5907","10481372",0,5,6,0,0,6
"5908","10481388",0,4,0,0,0,0
"5909","10481394",0,6,9,1,0,10
"5910","10481422",0,1,1,0,0,1
"5911","10481458",0,3,0,1,0,1
"5912","10481495",0,10,15,14,1,30
"5913","10481499",0,4,4,6,0,10
"5914","10481505",0,3,0,0,0,0
"5915","10481575",0,2,1,0,0,1
"5916","10481662",0,3,4,2,0,6
"5917","10481714",0,7,11,0,2,13
"5918","10481726",0,4,0,1,0,1
"5919","10481729",0,4,2,3,0,5
"5920","10481856",0,3,0,0,0,0
"5921","10481889",0,6,6,5,0,11
"5922","10481906",0,1,1,1,0,2
"5923","10481907",0,1,0,0,0,0
"5924","10481908",0,2,2,1,0,3
"5925","10481942",0,3,2,2,0,4
"5926","10481957",0,1,0,0,0,0
"5927","10482002",0,2,0,0,0,0
"5928","10482030",0,2,0,1,0,1
"5929","10482049",0,7,3,6,1,10
"5930","10482113",0,3,3,2,0,5
"5931","10482125",0,3,0,0,0,0
"5932","10482183",0,6,5,5,0,10
"5933","10482219",0,5,3,3,0,6
"5934","10482227",0,4,4,2,0,6
"5935","10482232",0,4,0,0,0,0
"5936","10482234",0,4,2,3,0,5
"5937","10482288",0,2,0,0,0,0
"5938","10482300",0,3,1,0,0,1
"5939","10482302",0,1,0,0,0,0
"5940","10482363",0,4,4,2,0,6
"5941","10482376",0,3,0,0,0,0
"5942","10482389",0,4,7,9,0,16
"5943","10482456",0,4,7,2,0,9
"5944","10482467",0,1,0,0,0,0
"5945","10482469",0,3,4,0,0,4
"5946","10482475",0,2,1,2,0,3
"5947","10482477",0,4,4,3,0,7
"5948","10482489",0,2,0,0,0,0
"5949","10482495",0,3,0,0,0,0
"5950","10482505",0,8,11,4,1,16
"5951","10482509",0,5,8,2,0,10
"5952","10482519",0,7,14,1,0,15
"5953","10482549",0,6,6,3,0,9
"5954","10482550",0,6,0,4,2,6
"5955","10482559",0,2,0,0,0,0
"5956","10482577",0,4,0,1,0,1
"5957","10482581",0,5,2,1,0,3
"5958","10482582",0,3,0,0,0,0
"5959","10482592",0,4,1,0,0,1
"5960","10482691",0,3,0,4,0,4
"5961","10482730",0,2,0,1,0,1
"5962","10482733",0,6,2,1,0,3
"5963","10482767",0,1,0,0,0,0
"5964","10482850",0,1,0,0,0,0
"5965","10482871",0,7,9,3,0,12
"5966","10482982",0,1,2,1,0,3
"5967","10482988",0,4,2,0,0,2
"5968","10483025",0,1,0,0,0,0
"5969","10483039",0,6,7,9,1,17
"5970","10483051",0,4,1,0,0,1
"5971","10483057",0,1,0,0,0,0
"5972","10483070",0,5,1,0,0,1
"5973","10483082",0,4,0,0,0,0
"5974","10483123",0,6,5,3,0,8
"5975","10483148",0,5,0,5,1,6
"5976","10483155",0,2,0,1,0,1
"5977","10483156",0,1,0,0,0,0
"5978","10483177",0,5,0,0,0,0
"5979","10483185",0,5,5,5,0,10
"5980","10483210",0,4,2,1,0,3
"5981","10483211",0,3,0,0,0,0
"5982","10483272",0,3,3,2,0,5
"5983","10483284",0,4,1,0,0,1
"5984","10483302",0,2,0,0,0,0
"5985","10483305",0,2,1,0,0,1
"5986","10483312",0,2,0,0,0,0
"5987","10483339",0,5,2,1,0,3
"5988","10483349",0,2,0,2,0,2
"5989","10483355",0,1,1,2,0,3
"5990","10483361",0,3,3,0,0,3
"5991","10483364",0,4,5,2,0,7
"5992","10483422",0,3,0,0,0,0
"5993","10483453",0,2,4,1,0,5
"5994","10483461",0,5,9,9,0,18
"5995","10483480",0,6,3,4,0,7
"5996","10483502",0,8,11,5,1,17
"5997","10483582",0,8,7,4,0,11
"5998","10483627",0,1,1,1,0,2
"5999","10483658",0,4,2,0,0,2
"6000","10483665",0,4,1,0,0,1
"6001","10483667",0,4,0,0,0,0
"6002","10483673",0,1,0,0,0,0
"6003","10483684",0,1,0,0,0,0
"6004","10483707",0,2,0,0,0,0
"6005","10483742",0,1,0,0,0,0
"6006","10483748",0,4,0,0,0,0
"6007","10483810",0,4,5,1,0,6
"6008","10483811",0,1,1,0,0,1
"6009","10483832",0,6,5,11,1,17
"6010","10483833",0,1,0,0,0,0
"6011","10483834",0,2,0,0,0,0
"6012","10483950",0,5,11,2,0,13
"6013","10483986",0,7,13,13,5,31
"6014","10483995",0,3,0,0,0,0
"6015","10484008",0,4,4,0,0,4
"6016","10484015",1,1,1,0,0,1
"6017","10484076",0,3,4,6,0,10
"6018","10484097",0,1,0,0,0,0
"6019","10484112",0,1,0,0,0,0
"6020","10484125",0,1,3,1,0,4
"6021","10484136",0,6,5,4,1,10
"6022","10484173",0,3,0,0,0,0
"6023","10484177",0,4,0,0,0,0
"6024","10484180",0,5,7,2,0,9
"6025","10484183",0,4,12,2,0,14
"6026","10484185",0,6,12,8,1,21
"6027","10484186",0,3,0,0,0,0
"6028","10484187",0,4,5,2,0,7
"6029","10484188",0,2,0,2,0,2
"6030","10484191",0,5,0,0,0,0
"6031","10484194",0,3,0,0,0,0
"6032","10484215",0,3,3,1,0,4
"6033","10484226",0,5,4,2,1,7
"6034","10484279",0,1,0,0,0,0
"6035","10484290",0,3,1,1,0,2
"6036","10484292",0,8,5,3,1,9
"6037","10484297",0,4,2,1,0,3
"6038","10484303",0,2,0,0,0,0
"6039","10484312",0,2,0,1,0,1
"6040","10484329",0,6,4,1,0,5
"6041","10484362",0,4,0,0,0,0
"6042","10484369",0,1,1,0,0,1
"6043","10484383",0,11,6,9,5,20
"6044","10484384",0,3,5,4,0,9
"6045","10484408",0,3,8,2,0,10
"6046","10484414",0,4,0,0,0,0
"6047","10484461",1,5,2,7,1,10
"6048","10484470",0,1,0,1,0,1
"6049","10484478",0,6,7,2,0,9
"6050","10484480",0,1,3,1,0,4
"6051","10484485",0,4,5,1,0,6
"6052","10484512",0,3,2,1,0,3
"6053","10484516",0,3,1,0,0,1
"6054","10484520",0,2,0,0,0,0
"6055","10484550",0,5,2,1,0,3
"6056","10484584",0,6,6,1,0,7
"6057","10484586",0,4,0,0,0,0
"6058","10484591",0,7,7,5,0,12
"6059","10484608",0,1,0,0,0,0
"6060","10484612",0,1,0,3,1,4
"6061","10484628",0,2,0,0,0,0
"6062","10484629",0,6,7,2,0,9
"6063","10484704",0,5,4,4,0,8
"6064","10484732",0,8,5,5,2,12
"6065","10484741",0,4,2,2,0,4
"6066","10484753",0,1,0,0,0,0
"6067","10484755",0,5,1,0,0,1
"6068","10484768",0,1,0,0,0,0
"6069","10484803",1,7,2,4,0,6
"6070","10484804",0,6,4,0,0,4
"6071","10484967",0,4,2,0,0,2
"6072","10484969",0,3,0,2,0,2
"6073","10484998",0,1,0,0,0,0
"6074","10485013",0,9,4,3,2,9
"6075","10485079",0,3,1,0,0,1
"6076","10485080",0,1,0,0,0,0
"6077","10485088",0,1,0,0,0,0
"6078","10485090",0,3,4,0,0,4
"6079","10485173",0,4,6,3,0,9
"6080","10485174",0,1,0,0,0,0
"6081","10485198",0,3,1,0,0,1
"6082","10485230",0,4,1,0,0,1
"6083","10485324",0,4,1,1,0,2
"6084","10485371",0,6,5,4,2,11
"6085","10485421",0,6,5,7,0,12
"6086","10485456",0,3,3,1,0,4
"6087","10485463",0,1,0,0,0,0
"6088","10485464",0,4,4,2,0,6
"6089","10485466",0,3,1,1,0,2
"6090","10485476",0,6,12,4,0,16
"6091","10485477",1,4,1,1,0,2
"6092","10485478",0,1,0,0,0,0
"6093","10485480",0,1,0,0,0,0
"6094","10485506",0,1,0,0,0,0
"6095","10485513",0,2,0,0,0,0
"6096","10485537",0,5,0,0,0,0
"6097","10485540",0,4,0,0,0,0
"6098","10485546",0,4,0,0,0,0
"6099","10485550",0,3,2,0,0,2
"6100","10485557",0,4,3,0,0,3
"6101","10485558",0,2,0,0,0,0
"6102","10485591",0,2,0,0,0,0
"6103","10485601",0,4,3,2,0,5
"6104","10485706",0,2,2,0,0,2
"6105","10485742",0,4,2,0,0,2
"6106","10485753",0,4,0,0,0,0
"6107","10485780",0,3,3,1,0,4
"6108","10485785",0,11,8,12,2,22
"6109","10485815",0,5,11,6,1,18
"6110","10485818",0,1,1,1,0,2
"6111","10485831",0,4,1,0,0,1
"6112","10485848",0,1,1,0,0,1
"6113","10485939",0,5,0,0,1,1
"6114","10485999",0,2,1,0,0,1
"6115","10486004",0,4,0,0,0,0
"6116","10486024",0,3,0,2,1,3
"6117","10486031",0,6,7,7,3,17
"6118","10486033",0,4,3,0,0,3
"6119","10486059",0,4,3,2,0,5
"6120","10486071",0,8,8,8,7,23
"6121","10486144",0,1,2,1,0,3
"6122","10486149",0,5,1,1,0,2
"6123","10486150",0,2,3,0,0,3
"6124","10486177",0,5,4,2,0,6
"6125","10486198",0,5,10,5,0,15
"6126","10486218",0,3,0,0,0,0
"6127","10486232",1,3,0,0,0,0
"6128","10486280",0,7,10,5,1,16
"6129","10486291",0,6,6,8,0,14
"6130","10486330",0,4,0,0,0,0
"6131","10486340",0,4,3,1,0,4
"6132","10486353",0,4,3,2,0,5
"6133","10486385",0,1,0,0,0,0
"6134","10486390",0,4,1,3,0,4
"6135","10486392",0,8,2,9,1,12
"6136","10486445",0,2,0,1,0,1
"6137","10486447",0,4,0,0,0,0
"6138","10486487",0,1,1,0,0,1
"6139","10486514",0,1,0,0,0,0
"6140","10486527",0,1,0,1,0,1
"6141","10486544",0,4,3,3,0,6
"6142","10486562",0,4,8,3,0,11
"6143","10486599",0,4,5,2,0,7
"6144","10486614",0,6,6,8,1,15
"6145","10486642",0,1,0,0,0,0
"6146","10486645",0,1,0,0,0,0
"6147","10486665",0,4,2,2,0,4
"6148","10486672",0,6,18,5,0,23
"6149","10486676",0,1,0,0,0,0
"6150","10486701",0,4,5,3,1,9
"6151","10486730",0,5,4,2,0,6
"6152","10486731",0,3,0,2,0,2
"6153","10486763",0,5,3,3,1,7
"6154","10486774",0,1,1,0,0,1
"6155","10486782",0,4,0,0,0,0
"6156","10486822",0,4,4,4,0,8
"6157","10486824",1,5,2,0,0,2
"6158","10486838",0,4,3,1,0,4
"6159","10486853",0,5,3,3,0,6
"6160","10486859",0,4,2,2,0,4
"6161","10486940",0,4,8,0,0,8
"6162","10486984",0,5,9,0,0,9
"6163","10486996",0,8,8,4,1,13
"6164","10487023",0,11,9,22,2,33
"6165","10487024",0,5,0,0,0,0
"6166","10487026",0,5,3,1,0,4
"6167","10487046",0,1,1,0,0,1
"6168","10487137",0,1,0,0,0,0
"6169","10487214",0,3,5,2,0,7
"6170","10487249",0,4,13,3,0,16
"6171","10487268",0,4,0,0,0,0
"6172","10487271",0,1,1,0,0,1
"6173","10487291",0,4,3,0,0,3
"6174","10487311",0,4,0,0,0,0
"6175","10487461",0,4,3,1,0,4
"6176","10487481",0,4,0,1,0,1
"6177","10487531",0,7,4,5,1,10
"6178","10487541",0,8,12,4,0,16
"6179","10487586",0,3,0,0,0,0
"6180","10487638",0,5,1,1,0,2
"6181","10487649",0,5,5,0,0,5
"6182","10487777",0,3,0,0,0,0
"6183","10487781",0,4,1,1,0,2
"6184","10487800",0,1,0,0,0,0
"6185","10487889",0,5,5,2,1,8
"6186","10487907",0,2,0,0,0,0
"6187","10487991",0,4,1,0,0,1
"6188","10488052",0,4,2,0,0,2
"6189","10488066",0,5,8,1,0,9
"6190","10488067",0,4,1,0,0,1
"6191","10488094",0,6,2,0,0,2
"6192","10488110",0,4,5,2,0,7
"6193","10488115",0,3,0,0,0,0
"6194","10488133",0,6,5,1,0,6
"6195","10488149",0,6,7,5,2,14
"6196","10488151",0,2,1,0,0,1
"6197","10488187",0,4,4,1,0,5
"6198","10488207",0,7,11,4,0,15
"6199","10488209",0,3,1,3,0,4
"6200","10488262",0,4,2,2,0,4
"6201","10488271",0,4,8,1,0,9
"6202","10488279",0,4,0,2,0,2
"6203","10488298",0,4,0,0,0,0
"6204","10488422",0,9,3,1,3,7
"6205","10488477",0,4,0,3,0,3
"6206","10488507",0,4,3,6,0,9
"6207","10488530",0,5,6,2,0,8
"6208","10488539",0,4,0,0,0,0
"6209","10488564",0,5,8,2,0,10
"6210","10488582",0,2,3,0,0,3
"6211","10488612",1,4,8,9,0,17
"6212","10488618",0,7,6,10,0,16
"6213","10488667",0,7,8,4,0,12
"6214","10488674",0,1,0,0,0,0
"6215","10488684",0,2,0,0,0,0
"6216","10488725",0,4,0,0,0,0
"6217","10488746",0,6,3,1,0,4
"6218","10488769",0,3,2,1,0,3
"6219","10488781",0,3,1,0,0,1
"6220","10488862",0,7,11,2,1,14
"6221","10488873",0,9,14,15,2,31
"6222","10488886",0,6,4,0,0,4
"6223","10488971",0,5,4,4,0,8
"6224","10489007",0,4,0,0,0,0
"6225","10489009",0,3,7,0,0,7
"6226","10489047",0,7,12,7,0,19
"6227","10489066",0,2,0,0,0,0
"6228","10489080",0,5,4,5,1,10
"6229","10489081",0,4,1,0,0,1
"6230","10489114",0,5,2,4,0,6
"6231","10489127",0,1,0,0,0,0
"6232","10489154",0,3,1,3,0,4
"6233","10489155",0,5,9,4,0,13
"6234","10489157",0,4,3,0,0,3
"6235","10489158",0,1,0,0,0,0
"6236","10489160",0,3,1,0,0,1
"6237","10489162",0,5,2,1,0,3
"6238","10489163",0,3,0,0,0,0
"6239","10489195",0,7,4,7,3,14
"6240","10489197",0,4,0,2,0,2
"6241","10489223",0,3,1,1,0,2
"6242","10489253",0,7,5,2,0,7
"6243","10489255",0,3,6,1,0,7
"6244","10489271",0,3,0,0,0,0
"6245","10489273",0,6,7,0,0,7
"6246","10489274",0,5,7,1,0,8
"6247","10489280",0,2,0,0,0,0
"6248","10489308",0,5,0,0,0,0
"6249","10489316",0,1,0,1,0,1
"6250","10489325",0,5,8,2,0,10
"6251","10489348",1,4,1,2,2,5
"6252","10489355",0,1,0,0,0,0
"6253","10489414",0,4,0,0,0,0
"6254","10489418",0,4,2,1,0,3
"6255","10489506",0,3,1,2,0,3
"6256","10489507",0,2,1,0,0,1
"6257","10489560",0,4,7,1,0,8
"6258","10489578",0,4,1,1,1,3
"6259","10489611",0,4,0,0,0,0
"6260","10489665",0,1,1,0,0,1
"6261","10489675",0,6,3,1,0,4
"6262","10489748",0,6,0,0,0,0
"6263","10489782",0,4,0,0,0,0
"6264","10489786",0,8,8,5,0,13
"6265","10489792",0,7,6,6,3,15
"6266","10489825",0,5,1,0,0,1
"6267","10489859",0,4,2,0,0,2
"6268","10489871",0,4,1,0,0,1
"6269","10489931",0,4,2,6,0,8
"6270","10489942",0,1,0,0,0,0
"6271","10489954",0,3,0,0,0,0
"6272","10489960",0,10,16,6,0,22
"6273","10489978",0,1,0,0,0,0
"6274","10489987",0,8,5,5,0,10
"6275","10489996",0,8,7,6,0,13
"6276","10490008",0,6,11,4,0,15
"6277","10490009",0,4,4,0,0,4
"6278","10490048",0,1,3,1,0,4
"6279","10490104",0,6,6,7,0,13
"6280","10490117",0,2,0,0,0,0
"6281","10490146",0,4,2,3,0,5
"6282","10490148",0,8,13,15,0,28
"6283","10490169",0,6,10,3,1,14
"6284","10490232",0,4,1,3,0,4
"6285","10490233",0,2,0,0,0,0
"6286","10490246",0,3,1,3,1,5
"6287","10490251",0,5,3,1,0,4
"6288","10490277",0,4,1,0,0,1
"6289","10490402",0,4,7,1,0,8
"6290","10490404",0,3,0,2,0,2
"6291","10490406",1,4,1,0,0,1
"6292","10490407",0,4,3,0,0,3
"6293","10490501",0,6,1,0,0,1
"6294","10490543",0,7,4,2,0,6
"6295","10490563",0,8,12,5,0,17
"6296","10490577",0,5,2,8,1,11
"6297","10490599",0,4,0,0,0,0
"6298","10490614",0,5,6,6,2,14
"6299","10490633",0,4,0,0,0,0
"6300","10490636",0,1,0,0,0,0
"6301","10490657",0,6,5,5,2,12
"6302","10490686",0,5,1,1,0,2
"6303","10490733",0,4,2,0,0,2
"6304","10490750",0,5,0,0,0,0
"6305","10490787",0,2,0,0,0,0
"6306","10490843",0,5,0,0,0,0
"6307","10490950",0,6,11,9,0,20
"6308","10490954",0,7,0,1,0,1
"6309","10490957",0,4,1,0,0,1
"6310","10490959",0,4,1,0,0,1
"6311","10491035",0,3,3,1,0,4
"6312","10491234",0,3,1,3,0,4
"6313","10491275",0,3,1,0,0,1
"6314","10491279",0,3,1,0,0,1
"6315","10491406",0,2,0,0,0,0
"6316","10491407",0,4,2,0,0,2
"6317","10491409",0,3,3,1,0,4
"6318","10491412",0,2,0,0,0,0
"6319","10491431",0,2,2,0,0,2
"6320","10491438",0,2,5,2,0,7
"6321","10491443",0,3,3,0,0,3
"6322","10491448",0,4,0,2,0,2
"6323","10491537",0,9,6,6,2,14
"6324","10491544",0,7,13,6,1,20
"6325","10491578",0,4,3,3,0,6
"6326","10491604",0,4,2,0,0,2
"6327","10491653",0,3,1,3,0,4
"6328","10491657",0,4,4,1,0,5
"6329","10491670",0,4,0,0,0,0
"6330","10491674",0,3,2,0,0,2
"6331","10491695",0,1,0,1,0,1
"6332","10491699",0,7,0,1,0,1
"6333","10491701",0,2,1,0,0,1
"6334","10491714",0,2,1,0,0,1
"6335","10491722",0,6,3,4,0,7
"6336","10491745",0,2,2,7,0,9
"6337","10491752",0,3,0,0,0,0
"6338","10491758",0,3,4,0,0,4
"6339","10491759",0,4,1,1,0,2
"6340","10491762",0,5,2,2,0,4
"6341","10491779",0,4,0,0,0,0
"6342","10491782",0,3,4,0,0,4
"6343","10491808",0,2,0,0,0,0
"6344","10491823",0,3,4,1,0,5
"6345","10491848",0,4,3,0,0,3
"6346","10491857",0,4,0,0,0,0
"6347","10491892",0,5,3,6,0,9
"6348","10491908",0,4,1,0,0,1
"6349","10491919",0,4,2,0,0,2
"6350","10491933",0,5,8,4,1,13
"6351","10491938",0,2,0,0,0,0
"6352","10491941",0,4,1,0,0,1
"6353","10491946",0,5,0,0,0,0
"6354","10491971",0,4,0,0,0,0
"6355","10491993",0,1,0,0,0,0
"6356","10491995",0,3,0,0,0,0
"6357","10491996",0,4,1,0,0,1
"6358","10492007",0,5,0,1,0,1
"6359","10492008",0,1,0,0,0,0
"6360","10492011",0,1,0,0,0,0
"6361","10492020",0,6,2,8,0,10
"6362","10492042",0,3,0,0,0,0
"6363","10492045",0,3,0,0,0,0
"6364","10492046",0,3,0,0,0,0
"6365","10492047",0,1,0,0,0,0
"6366","10492054",0,3,0,0,0,0
"6367","10492060",0,4,9,2,0,11
"6368","10492070",0,4,2,1,0,3
"6369","10492134",0,1,0,0,0,0
"6370","10492137",0,6,0,1,0,1
"6371","10492142",0,4,1,0,0,1
"6372","10492144",0,4,0,0,0,0
"6373","10492147",0,7,2,1,0,3
"6374","10492157",0,5,1,5,1,7
"6375","10492158",0,3,1,0,0,1
"6376","10492163",0,4,2,7,0,9
"6377","10492181",0,4,4,3,0,7
"6378","10492192",0,5,2,0,0,2
"6379","10492217",0,6,1,0,0,1
"6380","10492229",0,5,5,0,0,5
"6381","10492261",0,4,1,0,0,1
"6382","10492264",0,1,0,0,0,0
"6383","10492265",0,1,0,0,0,0
"6384","10492267",0,4,1,0,0,1
"6385","10492278",0,3,1,0,0,1
"6386","10492307",0,8,6,13,1,20
"6387","10492309",0,5,9,5,0,14
"6388","10492327",0,5,11,6,0,17
"6389","10492403",0,1,0,0,0,0
"6390","10492406",0,2,0,0,0,0
"6391","10492415",0,4,0,0,0,0
"6392","10492419",0,4,0,0,0,0
"6393","10492445",0,5,5,2,0,7
"6394","10492458",0,4,0,0,0,0
"6395","10492481",0,3,0,0,0,0
"6396","10492542",0,4,5,0,0,5
"6397","10492550",0,3,0,0,0,0
"6398","10492553",0,5,5,0,2,7
"6399","10492557",0,5,5,4,0,9
"6400","10492569",0,2,0,0,0,0
"6401","10492581",0,4,1,1,0,2
"6402","10492630",0,1,0,0,0,0
"6403","10492674",0,6,7,1,0,8
"6404","10492680",0,7,8,2,0,10
"6405","10492725",0,2,1,2,0,3
"6406","10492745",0,5,3,3,0,6
"6407","10492746",0,3,5,1,1,7
"6408","10492777",0,3,1,0,0,1
"6409","10492794",0,4,0,5,0,5
"6410","10492798",0,4,0,0,0,0
"6411","10492852",0,6,15,6,1,22
"6412","10492860",0,4,4,5,0,9
"6413","10492908",0,3,5,2,0,7
"6414","10492935",0,3,1,1,0,2
"6415","10493006",0,5,2,4,0,6
"6416","10493028",0,1,0,0,0,0
"6417","10493037",0,2,0,0,0,0
"6418","10493040",0,5,4,0,0,4
"6419","10493082",0,1,0,0,0,0
"6420","10493103",1,6,2,5,0,7
"6421","10493106",0,6,5,2,0,7
"6422","10493141",0,5,1,0,0,1
"6423","10493151",0,5,0,0,0,0
"6424","10493210",0,2,0,0,0,0
"6425","10493223",0,3,0,0,0,0
"6426","10493247",0,3,1,0,0,1
"6427","10493249",0,10,14,14,4,32
"6428","10493254",0,3,0,0,0,0
"6429","10493274",0,1,0,2,0,2
"6430","10493277",0,1,2,1,0,3
"6431","10493302",0,4,1,0,0,1
"6432","10493310",0,6,6,6,3,15
"6433","10493314",0,3,5,1,0,6
"6434","10493322",0,1,0,0,0,0
"6435","10493362",0,1,0,0,0,0
"6436","10493376",0,2,1,3,0,4
"6437","10493379",0,5,2,1,0,3
"6438","10493417",0,3,2,2,0,4
"6439","10493431",0,3,1,0,0,1
"6440","10493439",0,8,10,13,0,23
"6441","10493466",0,4,0,0,0,0
"6442","10493470",0,3,1,3,0,4
"6443","10493481",0,4,0,0,0,0
"6444","10493533",0,3,1,0,0,1
"6445","10493607",0,3,5,2,0,7
"6446","10493665",0,5,4,4,0,8
"6447","10493666",0,2,0,0,0,0
"6448","10493713",0,3,3,1,0,4
"6449","10493715",0,9,10,16,4,30
"6450","10493723",0,4,5,0,0,5
"6451","10493724",0,5,5,6,1,12
"6452","10493725",0,1,0,0,0,0
"6453","10493735",0,3,1,1,0,2
"6454","10493738",0,4,0,0,0,0
"6455","10493741",0,4,3,1,0,4
"6456","10493802",0,6,10,3,0,13
"6457","10493805",1,6,0,3,0,3
"6458","10493806",0,1,0,0,0,0
"6459","10493874",0,5,0,0,0,0
"6460","10493934",0,8,3,4,3,10
"6461","10493970",0,4,0,0,0,0
"6462","10493980",0,4,0,0,0,0
"6463","10494011",0,1,0,0,0,0
"6464","10494012",0,2,0,0,0,0
"6465","10494058",0,6,4,2,0,6
"6466","10494072",1,4,1,0,0,1
"6467","10494074",1,4,0,0,0,0
"6468","10494085",0,4,3,2,0,5
"6469","10494089",0,3,1,0,0,1
"6470","10494096",0,6,5,2,0,7
"6471","10494097",0,7,7,5,0,12
"6472","10494103",0,3,4,0,0,4
"6473","10494104",0,5,2,1,0,3
"6474","10494111",0,3,0,0,0,0
"6475","10494117",0,6,2,3,2,7
"6476","10494131",0,4,0,0,0,0
"6477","10494136",0,4,1,0,0,1
"6478","10494159",0,5,5,3,0,8
"6479","10494190",0,6,6,5,1,12
"6480","10494225",0,5,2,2,0,4
"6481","10494239",0,1,0,0,0,0
"6482","10494253",0,4,0,0,0,0
"6483","10494314",0,5,4,1,1,6
"6484","10494339",0,4,0,0,0,0
"6485","10494410",0,3,0,3,0,3
"6486","10494419",0,3,0,0,0,0
"6487","10494437",0,3,0,0,0,0
"6488","10494440",0,1,1,1,0,2
"6489","10494441",0,2,2,1,0,3
"6490","10494471",0,4,7,2,0,9
"6491","10494474",0,2,2,2,0,4
"6492","10494478",0,8,12,6,2,20
"6493","10494481",0,5,3,1,0,4
"6494","10494533",0,2,2,1,0,3
"6495","10494602",0,5,3,2,0,5
"6496","10494608",0,5,2,5,0,7
"6497","10494663",0,2,0,0,0,0
"6498","10494669",0,5,9,1,0,10
"6499","10494811",0,1,0,1,0,1
"6500","10494924",0,3,0,0,0,0
"6501","10495110",0,4,0,0,0,0
"6502","10495185",0,1,0,0,0,0
"6503","10495197",0,4,0,1,0,1
"6504","10495204",0,1,0,0,0,0
"6505","10495208",0,3,0,0,0,0
"6506","10495233",0,4,2,0,0,2
"6507","10495266",0,6,1,3,0,4
"6508","10495292",0,5,8,1,0,9
"6509","10495293",0,6,1,1,0,2
"6510","10495295",0,4,3,0,0,3
"6511","10495326",1,7,0,0,0,0
"6512","10495402",0,10,12,4,4,20
"6513","10495444",0,2,5,0,0,5
"6514","10495481",0,3,0,0,0,0
"6515","10495511",0,7,10,3,0,13
"6516","10495515",0,4,0,2,0,2
"6517","10495517",0,1,0,0,0,0
"6518","10495526",0,1,0,0,0,0
"6519","10495528",0,3,0,0,0,0
"6520","10495575",0,5,0,0,0,0
"6521","10495664",0,3,0,0,0,0
"6522","10495683",0,2,0,0,0,0
"6523","10495723",0,7,8,11,3,22
"6524","10495733",0,5,2,0,0,2
"6525","10495736",0,4,1,0,0,1
"6526","10495746",0,3,5,1,0,6
"6527","10495756",0,3,4,0,0,4
"6528","10495761",0,4,0,0,0,0
"6529","10495770",0,2,0,0,0,0
"6530","10495794",0,6,0,0,0,0
"6531","10495816",0,4,1,0,0,1
"6532","10495817",0,3,1,2,0,3
"6533","10495825",0,3,1,1,0,2
"6534","10495849",0,1,0,0,0,0
"6535","10495872",0,3,0,2,0,2
"6536","10495891",0,2,2,2,0,4
"6537","10495948",0,3,4,1,0,5
"6538","10495993",0,6,5,0,0,5
"6539","10496065",0,4,0,0,0,0
"6540","10496230",0,6,6,6,0,12
"6541","10496305",0,2,4,0,0,4
"6542","10496324",0,6,2,3,0,5
"6543","10496351",0,7,7,4,1,12
"6544","10496362",0,4,0,0,0,0
"6545","10496427",0,4,4,0,0,4
"6546","10496433",0,5,7,0,0,7
"6547","10496453",0,4,1,0,0,1
"6548","10496475",0,6,4,1,0,5
"6549","10496609",0,4,2,0,0,2
"6550","10496713",0,4,3,1,0,4
"6551","10496728",0,5,7,2,0,9
"6552","10496740",0,3,0,0,0,0
"6553","10496742",0,2,1,1,0,2
"6554","10496768",0,4,0,0,0,0
"6555","10496775",0,5,1,0,0,1
"6556","10496810",0,4,6,2,0,8
"6557","10496864",0,2,6,2,0,8
"6558","10496868",0,1,0,0,0,0
"6559","10496875",0,5,1,0,0,1
"6560","10496906",0,2,0,0,0,0
"6561","10496967",0,4,4,0,0,4
"6562","10496976",0,4,0,0,0,0
"6563","10497005",0,7,9,2,0,11
"6564","10497058",0,3,1,1,0,2
"6565","10497076",0,4,0,0,0,0
"6566","10497091",0,6,3,2,0,5
"6567","10497102",0,4,3,3,0,6
"6568","10497138",0,2,0,1,0,1
"6569","10497140",0,5,5,4,0,9
"6570","10497211",0,6,6,1,0,7
"6571","10497246",0,4,7,2,0,9
"6572","10497261",0,3,0,0,0,0
"6573","10497262",0,3,0,2,0,2
"6574","10497311",0,8,12,4,0,16
"6575","10497331",0,6,1,4,1,6
"6576","10497439",0,5,5,4,0,9
"6577","10497443",0,3,0,0,0,0
"6578","10497549",0,7,6,8,4,18
"6579","10497554",0,4,0,0,0,0
"6580","10497705",0,5,0,1,0,1
"6581","10497746",0,2,0,0,0,0
"6582","10497762",0,7,3,4,1,8
"6583","10497804",0,7,10,1,0,11
"6584","10497805",0,3,3,0,0,3
"6585","10497817",0,1,0,0,0,0
"6586","10497842",0,3,2,1,0,3
"6587","10497917",0,4,4,7,0,11
"6588","10498015",0,4,3,1,0,4
"6589","10498032",0,2,0,0,0,0
"6590","10498056",0,2,1,0,0,1
"6591","10498064",0,2,0,0,0,0
"6592","10498066",0,1,2,0,0,2
"6593","10498085",0,3,1,1,0,2
"6594","10498088",0,4,0,2,0,2
"6595","10498170",0,4,6,0,0,6
"6596","10498189",0,3,1,2,0,3
"6597","10498219",0,5,4,0,0,4
"6598","10498223",0,2,0,0,0,0
"6599","10498297",0,7,3,3,0,6
"6600","10498302",0,4,0,1,0,1
"6601","10498337",0,2,1,1,0,2
"6602","10498342",0,6,6,6,1,13
"6603","10498356",0,2,0,0,0,0
"6604","10498503",0,4,3,0,1,4
"6605","10498574",0,3,0,1,0,1
"6606","10498582",0,4,0,0,0,0
"6607","10498590",0,1,0,0,0,0
"6608","10498647",0,3,0,1,0,1
"6609","10498651",0,5,2,0,0,2
"6610","10498655",0,2,0,0,0,0
"6611","10498668",0,2,0,0,0,0
"6612","10498670",0,2,0,3,0,3
"6613","10498678",0,6,6,9,1,16
"6614","10498783",0,1,0,0,0,0
"6615","10498786",0,4,4,5,0,9
"6616","10498804",0,7,12,7,1,20
"6617","10498919",0,1,0,1,0,1
"6618","10498979",1,5,0,0,0,0
"6619","10499028",0,4,1,0,0,1
"6620","10499091",0,10,6,8,2,16
"6621","10499118",0,1,0,1,0,1
"6622","10499127",0,4,0,2,0,2
"6623","10499170",0,3,0,0,0,0
"6624","10499191",0,1,3,1,0,4
"6625","10499246",0,6,5,2,0,7
"6626","10499253",0,3,1,0,0,1
"6627","10499311",0,4,8,3,0,11
"6628","10499424",0,1,0,0,0,0
"6629","10499462",0,3,0,0,0,0
"6630","10499511",0,1,0,0,0,0
"6631","10499578",0,3,0,0,0,0
"6632","10499583",0,4,7,0,0,7
"6633","10499594",0,4,3,4,0,7
"6634","10499595",0,7,7,2,0,9
"6635","10499620",0,4,0,0,0,0
"6636","10499621",0,8,10,7,0,17
"6637","10499665",0,6,5,8,1,14
"6638","10499666",0,5,1,5,0,6
"6639","10499681",0,8,9,3,2,14
"6640","10499704",0,4,5,5,0,10
"6641","10499705",0,2,0,0,0,0
"6642","10499706",0,2,3,1,0,4
"6643","10499729",0,4,6,8,0,14
"6644","10499745",0,2,1,0,0,1
"6645","10499812",0,2,1,2,0,3
"6646","10499835",0,7,7,6,0,13
"6647","10499855",0,9,11,8,2,21
"6648","10499893",0,1,1,0,0,1
"6649","10499926",0,1,0,0,0,0
"6650","10499947",0,3,2,0,0,2
"6651","10499954",0,4,1,0,0,1
"6652","10499964",0,4,0,0,0,0
"6653","10499971",0,7,6,6,0,12
"6654","10499978",0,2,1,1,0,2
"6655","10500065",0,3,0,0,0,0
"6656","10500066",0,4,3,1,0,4
"6657","10500071",0,2,2,0,0,2
"6658","10500076",0,2,0,2,0,2
"6659","10500078",0,5,0,2,0,2
"6660","10500166",0,1,0,0,0,0
"6661","10500170",0,4,0,1,0,1
"6662","10500176",0,3,0,0,0,0
"6663","10500186",0,5,3,0,0,3
"6664","10500213",0,3,6,3,0,9
"6665","10500246",0,1,1,0,0,1
"6666","10500252",0,3,0,1,0,1
"6667","10500262",0,2,0,0,0,0
"6668","10500308",0,5,4,4,0,8
"6669","10500332",0,6,6,7,2,15
"6670","10500338",0,4,0,0,0,0
"6671","10500341",0,4,0,0,0,0
"6672","10500342",0,5,5,2,0,7
"6673","10500399",0,4,0,0,0,0
"6674","10500438",0,3,0,0,0,0
"6675","10500454",0,4,1,1,0,2
"6676","10500463",0,4,0,1,0,1
"6677","10500468",1,3,0,0,0,0
"6678","10500471",0,6,2,2,0,4
"6679","10500502",0,2,0,0,0,0
"6680","10500509",1,4,1,0,0,1
"6681","10500548",0,6,5,4,1,10
"6682","10500552",0,2,1,0,0,1
"6683","10500602",0,2,1,2,0,3
"6684","10500604",0,2,2,1,0,3
"6685","10500712",0,2,0,0,0,0
"6686","10500715",0,1,0,0,0,0
"6687","10500735",1,5,0,0,0,0
"6688","10500739",0,1,0,1,0,1
"6689","10500741",0,1,0,0,0,0
"6690","10500763",0,2,0,0,0,0
"6691","10500766",0,4,1,0,0,1
"6692","10500785",0,2,4,1,0,5
"6693","10500790",0,1,1,0,0,1
"6694","10500791",0,4,5,2,0,7
"6695","10500896",0,1,0,0,0,0
"6696","10500903",0,1,0,0,0,0
"6697","10500914",0,4,1,2,0,3
"6698","10500917",0,1,0,0,0,0
"6699","10500943",0,3,0,0,0,0
"6700","10500953",0,6,1,3,0,4
"6701","10500957",0,1,0,0,0,0
"6702","10500958",0,4,2,0,0,2
"6703","10500961",0,2,0,0,0,0
"6704","10500962",0,1,0,0,0,0
"6705","10500965",0,6,7,1,3,11
"6706","10500967",0,5,7,6,0,13
"6707","10500972",0,3,6,1,0,7
"6708","10500996",0,3,4,1,0,5
"6709","10500998",0,2,3,0,0,3
"6710","10501000",0,1,0,0,0,0
"6711","10501005",0,1,0,1,0,1
"6712","10501010",0,1,1,0,0,1
"6713","10501015",0,1,0,2,0,2
"6714","10501027",0,1,0,0,0,0
"6715","10501028",0,5,3,2,0,5
"6716","10501056",0,1,0,0,0,0
"6717","10501063",0,3,0,2,0,2
"6718","10501065",0,1,0,0,0,0
"6719","10501066",0,1,0,0,0,0
"6720","10501077",0,1,2,0,0,2
"6721","10501105",0,2,0,0,0,0
"6722","10501109",0,1,0,0,0,0
"6723","10501117",0,1,0,0,0,0
"6724","10501119",0,2,2,1,0,3
"6725","10501125",1,5,1,3,0,4
"6726","10501156",0,1,0,0,0,0
"6727","10501174",0,1,0,0,0,0
"6728","10501176",0,1,1,1,0,2
"6729","10501181",0,1,0,1,0,1
"6730","10501193",0,4,5,2,0,7
"6731","10501194",0,5,2,2,0,4
"6732","10501199",0,2,0,0,0,0
"6733","10501208",0,2,0,0,0,0
"6734","10501222",0,1,0,0,0,0
"6735","10501239",0,1,0,0,0,0
"6736","10501248",0,3,0,0,0,0
"6737","10501255",0,2,0,0,0,0
"6738","10501257",0,3,1,0,0,1
"6739","10501260",0,2,2,1,0,3
"6740","10501262",0,3,0,0,0,0
"6741","10501279",0,5,5,6,0,11
"6742","10501289",0,1,0,0,0,0
"6743","10501292",0,1,0,0,0,0
"6744","10501293",0,1,0,0,0,0
"6745","10501305",0,1,0,0,0,0
"6746","10501324",0,2,0,0,0,0
"6747","10501383",0,1,1,0,0,1
"6748","10501389",0,3,0,0,0,0
"6749","10501406",0,4,0,0,0,0
"6750","10501412",0,4,1,0,0,1
"6751","10501436",0,6,4,5,2,11
"6752","10501453",0,2,0,1,0,1
"6753","10501459",0,1,0,0,0,0
"6754","10501470",0,4,2,1,0,3
"6755","10501588",0,2,0,0,0,0
"6756","10501593",0,5,5,2,0,7
"6757","10501595",0,7,2,3,0,5
"6758","10501596",0,6,2,3,0,5
"6759","10501597",0,1,0,0,0,0
"6760","10501603",0,2,0,0,0,0
"6761","10501604",0,10,8,7,5,20
"6762","10501610",0,3,6,0,0,6
"6763","10501626",0,1,1,0,0,1
"6764","10501674",0,6,2,3,2,7
"6765","10501675",0,4,3,0,0,3
"6766","10501676",0,3,0,0,0,0
"6767","10501760",0,4,0,0,0,0
"6768","10501789",0,4,1,0,0,1
"6769","10501835",0,6,6,8,0,14
"6770","10501841",0,1,0,0,0,0
"6771","10501847",0,1,0,0,0,0
"6772","10501858",0,5,3,0,0,3
"6773","10501902",0,1,0,2,0,2
"6774","10501907",0,1,0,1,0,1
"6775","10501910",0,1,0,0,0,0
"6776","10501918",0,4,7,1,0,8
"6777","10501946",0,4,4,0,0,4
"6778","10502072",0,4,2,0,0,2
"6779","10502074",0,3,4,2,0,6
"6780","10502075",0,2,0,2,0,2
"6781","10502102",0,4,1,0,0,1
"6782","10502132",0,5,4,3,0,7
"6783","10502155",0,1,0,0,0,0
"6784","10502174",0,4,4,4,0,8
"6785","10502188",0,1,0,0,0,0
"6786","10502214",0,4,1,1,0,2
"6787","10502225",0,5,7,2,0,9
"6788","10502226",0,5,4,2,0,6
"6789","10502232",0,1,0,0,0,0
"6790","10502235",0,1,0,0,0,0
"6791","10502237",0,3,1,0,0,1
"6792","10502239",0,6,11,2,1,14
"6793","10502245",0,2,0,0,0,0
"6794","10502257",0,1,0,0,0,0
"6795","10502273",0,4,1,5,0,6
"6796","10502275",0,1,0,0,0,0
"6797","10502279",0,3,0,0,0,0
"6798","10502283",0,3,5,5,0,10
"6799","10502287",0,4,0,0,0,0
"6800","10502288",0,2,0,1,0,1
"6801","10502289",0,4,1,2,0,3
"6802","10502301",0,1,0,0,0,0
"6803","10502339",0,2,3,0,0,3
"6804","10502368",0,3,3,2,0,5
"6805","10502437",0,4,0,0,0,0
"6806","10502441",0,4,0,0,0,0
"6807","10502460",0,8,11,16,2,29
"6808","10502461",0,6,5,5,0,10
"6809","10502526",0,6,4,4,0,8
"6810","10502648",0,3,1,0,0,1
"6811","10502708",0,4,3,2,0,5
"6812","10502823",0,5,7,2,0,9
"6813","10502862",0,3,0,2,0,2
"6814","10502884",0,4,0,0,0,0
"6815","10502937",0,4,4,0,0,4
"6816","10502940",0,5,0,1,0,1
"6817","10502941",0,4,3,0,0,3
"6818","10502985",0,8,2,4,4,10
"6819","10502997",0,7,1,1,0,2
"6820","10503005",1,7,4,6,3,13
"6821","10503006",0,3,0,0,0,0
"6822","10503008",0,6,8,4,0,12
"6823","10503030",0,5,2,3,0,5
"6824","10503033",0,4,0,0,0,0
"6825","10503081",0,3,0,0,0,0
"6826","10503091",0,1,0,0,0,0
"6827","10503118",0,1,0,0,0,0
"6828","10503119",0,1,0,0,0,0
"6829","10503122",0,2,1,0,0,1
"6830","10503124",0,4,6,4,1,11
"6831","10503125",0,1,0,0,0,0
"6832","10503128",0,4,10,7,0,17
"6833","10503133",0,1,0,0,0,0
"6834","10503134",0,1,1,0,0,1
"6835","10503345",0,2,3,0,0,3
"6836","10503377",0,2,0,0,0,0
"6837","10503380",0,2,0,0,0,0
"6838","10503412",0,7,7,2,2,11
"6839","10503418",0,5,11,2,0,13
"6840","10503531",0,5,0,4,0,4
"6841","10503532",0,1,0,0,0,0
"6842","10503581",0,2,2,0,0,2
"6843","10503629",0,5,4,0,0,4
"6844","10503633",0,4,4,2,1,7
"6845","10503663",0,3,0,1,0,1
"6846","10503666",0,1,0,0,0,0
"6847","10503669",0,8,13,8,0,21
"6848","10503670",0,4,1,0,0,1
"6849","10503683",0,2,0,0,0,0
"6850","10503690",0,6,2,3,1,6
"6851","10503715",0,2,0,0,0,0
"6852","10503717",0,1,3,1,0,4
"6853","10503731",0,4,1,3,0,4
"6854","10503811",0,2,0,1,0,1
"6855","10503815",0,4,0,0,0,0
"6856","10503892",0,5,2,3,0,5
"6857","10503931",0,4,1,0,0,1
"6858","10503937",0,2,1,0,2,3
"6859","10503990",0,3,5,3,0,8
"6860","10504022",0,4,2,2,0,4
"6861","10504026",0,3,0,1,0,1
"6862","10504122",0,3,1,0,0,1
"6863","10504124",1,8,4,1,0,5
"6864","10504133",0,6,7,6,1,14
"6865","10504222",0,7,1,0,0,1
"6866","10504229",0,5,4,0,0,4
"6867","10504244",0,1,3,0,0,3
"6868","10504270",0,5,10,10,1,21
"6869","10504275",0,5,5,1,0,6
"6870","10504279",0,1,0,0,0,0
"6871","10504330",0,4,2,2,0,4
"6872","10504331",0,4,4,0,0,4
"6873","10504333",0,3,0,0,0,0
"6874","10504345",0,4,3,4,0,7
"6875","10504357",0,2,0,0,0,0
"6876","10504483",0,3,2,2,0,4
"6877","10504508",0,5,5,6,0,11
"6878","10504536",0,1,0,0,0,0
"6879","10504690",0,5,9,4,0,13
"6880","10504691",0,2,0,0,0,0
"6881","10504694",0,3,2,0,0,2
"6882","10504699",0,8,11,4,1,16
"6883","10504721",0,4,7,1,0,8
"6884","10504722",0,5,0,0,0,0
"6885","10504775",0,1,1,0,0,1
"6886","10504796",0,4,2,0,0,2
"6887","10504829",0,1,1,1,0,2
"6888","10504841",0,3,0,1,0,1
"6889","10504868",0,3,0,0,0,0
"6890","10504878",0,4,7,1,0,8
"6891","10504911",0,8,5,9,0,14
"6892","10504936",0,2,1,2,0,3
"6893","10505036",0,5,4,1,0,5
"6894","10505043",0,6,0,4,0,4
"6895","10505068",0,4,0,0,0,0
"6896","10505118",0,2,0,0,0,0
"6897","10505121",0,6,5,3,0,8
"6898","10505151",0,8,8,6,0,14
"6899","10505158",0,5,3,0,0,3
"6900","10505174",0,1,0,1,0,1
"6901","10505223",0,4,4,3,0,7
"6902","10505308",0,3,3,1,0,4
"6903","10505332",0,4,1,0,0,1
"6904","10505392",1,4,0,0,0,0
"6905","10505455",0,5,0,0,0,0
"6906","10505462",0,6,4,0,1,5
"6907","10505537",0,4,3,1,0,4
"6908","10505554",0,4,5,0,0,5
"6909","10505590",0,3,5,3,0,8
"6910","10505600",0,6,10,9,0,19
"6911","10505610",0,1,1,0,0,1
"6912","10505626",0,4,3,0,0,3
"6913","10505670",0,3,1,1,0,2
"6914","10505722",0,3,0,0,0,0
"6915","10505726",0,7,6,8,0,14
"6916","10505731",0,4,4,1,0,5
"6917","10505735",0,1,1,1,0,2
"6918","10505737",0,4,0,0,0,0
"6919","10505738",0,4,0,0,0,0
"6920","10505740",0,1,0,0,0,0
"6921","10505742",0,1,0,3,0,3
"6922","10505747",0,5,0,6,0,6
"6923","10505758",0,7,3,6,0,9
"6924","10505824",0,6,5,3,0,8
"6925","10505830",0,3,0,0,0,0
"6926","10505841",0,1,0,0,0,0
"6927","10505925",0,4,0,0,0,0
"6928","10505980",0,3,0,0,0,0
"6929","10506004",0,2,0,0,0,0
"6930","10506005",0,1,0,2,0,2
"6931","10506037",0,1,0,0,0,0
"6932","10506051",1,2,0,0,0,0
"6933","10506095",0,5,2,4,0,6
"6934","10506108",0,4,4,3,0,7
"6935","10506137",0,5,0,2,0,2
"6936","10506294",0,3,4,0,0,4
"6937","10506349",0,5,0,0,0,0
"6938","10506371",0,4,1,2,0,3
"6939","10506429",0,2,1,2,0,3
"6940","10506433",0,1,2,1,0,3
"6941","10506434",0,4,2,3,0,5
"6942","10506435",0,2,0,0,0,0
"6943","10506436",0,1,0,0,0,0
"6944","10506437",0,2,1,0,0,1
"6945","10506644",0,5,4,4,0,8
"6946","10506745",0,7,6,1,0,7
"6947","10506775",0,4,2,1,0,3
"6948","10506787",0,1,0,0,0,0
"6949","10506855",0,5,4,2,0,6
"6950","10506866",0,5,8,0,0,8
"6951","10506894",0,2,1,0,0,1
"6952","10506913",0,4,4,0,0,4
"6953","10507002",0,6,6,7,0,13
"6954","10507003",0,4,2,0,0,2
"6955","10507009",0,5,4,1,0,5
"6956","10507044",0,4,0,0,0,0
"6957","10507045",0,5,1,2,0,3
"6958","10507109",0,4,1,0,0,1
"6959","10507119",0,5,3,4,0,7
"6960","10507149",0,2,0,0,0,0
"6961","10507183",0,1,0,0,0,0
"6962","10507184",0,2,1,1,0,2
"6963","10507185",0,3,1,2,0,3
"6964","10507209",0,1,1,1,0,2
"6965","10507211",0,4,0,0,0,0
"6966","10507229",0,7,12,8,0,20
"6967","10507239",0,5,2,1,0,3
"6968","10507241",0,9,8,9,2,19
"6969","10507244",0,2,0,0,0,0
"6970","10507257",0,4,0,0,0,0
"6971","10507268",0,4,2,0,0,2
"6972","10507279",0,6,0,0,2,2
"6973","10507284",0,4,1,3,0,4
"6974","10507285",0,4,0,0,0,0
"6975","10507288",0,4,1,1,0,2
"6976","10507289",0,1,0,0,0,0
"6977","10507291",0,4,0,1,0,1
"6978","10507292",0,5,0,0,0,0
"6979","10507299",0,5,3,2,0,5
"6980","10507302",0,4,4,6,0,10
"6981","10507313",0,1,0,0,0,0
"6982","10507343",0,3,4,4,2,10
"6983","10507344",0,2,0,0,0,0
"6984","10507401",0,3,0,0,0,0
"6985","10507405",0,4,5,3,0,8
"6986","10507415",0,5,0,0,1,1
"6987","10507429",0,2,0,1,1,2
"6988","10507431",0,5,1,1,0,2
"6989","10507434",0,1,0,0,0,0
"6990","10507436",0,1,0,0,0,0
"6991","10507437",0,2,0,1,0,1
"6992","10507438",0,3,1,0,0,1
"6993","10507442",0,4,1,2,0,3
"6994","10507450",0,7,12,1,1,14
"6995","10507451",0,3,0,1,0,1
"6996","10507456",0,3,0,0,1,1
"6997","10507460",0,4,1,1,0,2
"6998","10507462",0,4,0,2,0,2
"6999","10507463",0,5,0,1,0,1
"7000","10507467",0,4,0,0,0,0
"7001","10507478",0,3,0,0,0,0
"7002","10507507",0,1,0,0,0,0
"7003","10507509",0,1,0,0,0,0
"7004","10507541",0,4,0,2,0,2
"7005","10507548",0,3,0,5,0,5
"7006","10507621",0,1,0,0,0,0
"7007","10507623",0,4,4,0,0,4
"7008","10507627",0,1,0,2,0,2
"7009","10507633",0,2,0,0,0,0
"7010","10507659",0,2,0,0,0,0
"7011","10507759",0,6,4,0,0,4
"7012","10507795",0,3,1,0,0,1
"7013","10507806",0,4,0,0,0,0
"7014","10507825",0,6,3,4,0,7
"7015","10507828",0,7,1,1,1,3
"7016","10507831",0,4,2,3,1,6
"7017","10507834",0,1,0,0,0,0
"7018","10507835",0,4,0,2,0,2
"7019","10507867",0,4,4,2,0,6
"7020","10508087",0,6,2,3,0,5
"7021","10508088",0,2,2,1,0,3
"7022","10508103",0,4,3,2,0,5
"7023","10508109",0,2,2,0,0,2
"7024","10508110",0,6,6,2,0,8
"7025","10508115",0,7,10,2,0,12
"7026","10508117",0,5,0,3,0,3
"7027","10508133",1,4,1,0,0,1
"7028","10508160",0,8,7,4,2,13
"7029","10508174",0,2,0,0,0,0
"7030","10508184",0,3,2,3,0,5
"7031","10508201",1,2,0,0,0,0
"7032","10508204",1,2,0,0,0,0
"7033","10508213",0,7,0,2,0,2
"7034","10508224",0,7,0,3,2,5
"7035","10508234",0,2,0,0,0,0
"7036","10508249",0,2,1,0,0,1
"7037","10508253",0,6,0,0,0,0
"7038","10508323",0,1,1,0,0,1
"7039","10508336",1,3,0,1,0,1
"7040","10508363",0,2,0,0,0,0
"7041","10508365",0,5,0,0,0,0
"7042","10508374",0,4,0,0,0,0
"7043","10508375",0,4,0,0,0,0
"7044","10508378",0,3,0,0,0,0
"7045","10508401",0,2,1,1,0,2
"7046","10508424",0,2,2,0,0,2
"7047","10508456",0,3,0,1,0,1
"7048","10508464",0,2,4,1,0,5
"7049","10508507",0,5,1,3,0,4
"7050","10508621",0,4,0,0,0,0
"7051","10508622",0,3,2,0,0,2
"7052","10508676",0,10,19,18,3,40
"7053","10508712",0,1,0,0,0,0
"7054","10508778",0,3,0,0,0,0
"7055","10508801",0,2,2,1,0,3
"7056","10508819",0,5,8,5,1,14
"7057","10508861",0,3,1,4,0,5
"7058","10508866",0,4,2,0,0,2
"7059","10508901",0,4,2,0,0,2
"7060","10508927",0,4,0,0,0,0
"7061","10508937",0,2,0,0,0,0
"7062","10508988",0,6,5,13,4,22
"7063","10509026",0,4,1,5,0,6
"7064","10509030",0,3,0,0,0,0
"7065","10509061",0,3,4,1,0,5
"7066","10509071",0,1,0,0,0,0
"7067","10509089",0,6,1,0,0,1
"7068","10509105",0,8,6,4,0,10
"7069","10509111",0,7,3,4,0,7
"7070","10509112",0,2,1,0,1,2
"7071","10509120",0,2,4,1,0,5
"7072","10509146",0,2,6,2,0,8
"7073","10509147",0,1,0,0,0,0
"7074","10509148",0,5,1,2,0,3
"7075","10509149",0,4,0,2,0,2
"7076","10509150",0,2,0,0,0,0
"7077","10509151",0,5,2,4,0,6
"7078","10509153",0,4,4,3,0,7
"7079","10509232",0,4,8,0,0,8
"7080","10509273",0,6,9,1,0,10
"7081","10509291",0,5,5,1,0,6
"7082","10509292",0,5,0,0,0,0
"7083","10509295",0,4,2,1,0,3
"7084","10509465",0,4,0,0,0,0
"7085","10509476",1,2,0,0,0,0
"7086","10509552",0,3,0,2,0,2
"7087","10509573",0,4,3,1,0,4
"7088","10509597",0,12,12,8,0,20
"7089","10509710",0,2,0,0,0,0
"7090","10509757",0,3,0,0,0,0
"7091","10509784",0,4,0,0,0,0
"7092","10509834",0,4,1,3,2,6
"7093","10509865",0,5,1,3,0,4
"7094","10509931",0,4,7,1,0,8
"7095","10509955",0,4,0,2,0,2
"7096","10509973",0,6,4,13,1,18
"7097","10510078",0,4,0,0,0,0
"7098","10510118",0,3,0,0,0,0
"7099","10510162",0,2,2,0,0,2
"7100","10510166",0,3,4,1,0,5
"7101","10510170",0,1,1,0,0,1
"7102","10510197",0,4,0,0,0,0
"7103","10510204",0,5,9,3,0,12
"7104","10510205",0,4,4,1,0,5
"7105","10510213",0,5,6,0,0,6
"7106","10510216",0,6,3,2,1,6
"7107","10510283",0,4,2,2,0,4
"7108","10510295",0,4,0,0,0,0
"7109","10510346",0,5,0,0,0,0
"7110","10510362",0,2,2,0,0,2
"7111","10510375",0,3,5,4,0,9
"7112","10510376",0,3,5,1,0,6
"7113","10510409",0,2,3,0,0,3
"7114","10510512",0,6,8,4,0,12
"7115","10510536",0,3,0,0,0,0
"7116","10510615",0,3,0,0,0,0
"7117","10510636",0,4,0,0,0,0
"7118","10510660",0,6,0,0,0,0
"7119","10510665",0,3,0,0,0,0
"7120","10510668",0,4,0,0,0,0
"7121","10510669",0,2,1,0,0,1
"7122","10510712",0,3,0,0,0,0
"7123","10510726",0,4,0,1,0,1
"7124","10510818",0,5,0,0,0,0
"7125","10510821",0,3,0,1,0,1
"7126","10510856",0,3,0,0,0,0
"7127","10510889",0,7,5,6,2,13
"7128","10510913",0,1,0,0,0,0
"7129","10510916",0,5,0,0,0,0
"7130","10510971",0,4,0,0,0,0
"7131","10510978",0,1,0,1,0,1
"7132","10510981",0,4,3,0,0,3
"7133","10511075",0,3,0,0,0,0
"7134","10511086",0,1,0,1,0,1
"7135","10511094",0,2,0,0,0,0
"7136","10511101",0,4,0,0,0,0
"7137","10511102",0,5,6,5,0,11
"7138","10511113",0,2,3,0,0,3
"7139","10511121",0,5,5,6,0,11
"7140","10511127",0,3,2,0,0,2
"7141","10511142",0,4,7,4,0,11
"7142","10511143",0,5,1,1,0,2
"7143","10511148",0,4,1,0,0,1
"7144","10511149",0,5,0,1,0,1
"7145","10511153",0,5,2,1,0,3
"7146","10511157",0,4,3,1,0,4
"7147","10511163",0,4,1,0,0,1
"7148","10511269",0,1,2,0,0,2
"7149","10511270",0,4,0,0,0,0
"7150","10511288",0,6,0,1,0,1
"7151","10511318",0,3,4,0,0,4
"7152","10511344",0,3,2,1,0,3
"7153","10511424",0,2,0,0,0,0
"7154","10511445",0,4,0,1,0,1
"7155","10511446",0,4,1,0,0,1
"7156","10511455",0,4,4,2,0,6
"7157","10511472",0,1,0,0,0,0
"7158","10511477",0,5,6,8,1,15
"7159","10511478",0,3,0,2,0,2
"7160","10511483",0,2,0,0,0,0
"7161","10511497",0,4,1,5,0,6
"7162","10511524",0,5,1,1,0,2
"7163","10511532",0,6,0,3,0,3
"7164","10511581",0,7,2,3,0,5
"7165","10511589",0,5,2,0,0,2
"7166","10511590",0,3,0,0,0,0
"7167","10511613",0,3,1,2,0,3
"7168","10511631",0,1,0,0,0,0
"7169","10511634",0,4,0,1,0,1
"7170","10511637",0,4,2,0,0,2
"7171","10511668",0,4,1,1,0,2
"7172","10511692",0,5,10,1,0,11
"7173","10511705",0,7,1,1,0,2
"7174","10511710",0,1,0,0,0,0
"7175","10511748",0,1,0,0,0,0
"7176","10511760",0,9,17,5,0,22
"7177","10511771",0,8,5,6,1,12
"7178","10511773",0,4,2,0,0,2
"7179","10511777",0,4,1,0,0,1
"7180","10511780",0,4,0,0,0,0
"7181","10511783",0,6,0,5,0,5
"7182","10511842",0,5,1,0,0,1
"7183","10511845",0,4,0,2,0,2
"7184","10511852",0,8,22,7,0,29
"7185","10511860",0,2,1,0,0,1
"7186","10511949",0,1,0,0,0,0
"7187","10511969",0,5,2,1,0,3
"7188","10512065",0,4,1,1,0,2
"7189","10512069",0,5,1,0,0,1
"7190","10512190",0,4,2,4,1,7
"7191","10512201",0,3,1,1,0,2
"7192","10512202",0,5,5,2,0,7
"7193","10512257",0,2,0,0,1,1
"7194","10512302",0,6,6,9,1,16
"7195","10512307",0,4,0,0,0,0
"7196","10512315",0,6,2,3,1,6
"7197","10512333",0,8,15,8,0,23
"7198","10512342",0,5,0,3,0,3
"7199","10512360",0,5,11,7,0,18
"7200","10512416",0,4,0,0,0,0
"7201","10512425",0,7,10,4,0,14
"7202","10512427",0,4,3,0,0,3
"7203","10512430",0,2,3,0,0,3
"7204","10512435",0,1,2,0,0,2
"7205","10512464",0,4,1,0,0,1
"7206","10512469",0,3,2,2,0,4
"7207","10512479",0,2,0,0,0,0
"7208","10512607",0,4,2,3,0,5
"7209","10512618",0,3,0,0,0,0
"7210","10512627",0,5,0,2,0,2
"7211","10512687",0,7,0,1,0,1
"7212","10512699",0,4,3,2,0,5
"7213","10512744",0,3,4,4,0,8
"7214","10512747",0,6,3,3,0,6
"7215","10512750",0,2,0,0,0,0
"7216","10512806",0,4,1,2,0,3
"7217","10512814",0,2,0,0,0,0
"7218","10512867",0,4,0,0,0,0
"7219","10512878",0,6,6,2,0,8
"7220","10512879",0,7,6,7,1,14
"7221","10512882",0,5,2,4,0,6
"7222","10512913",0,4,0,1,0,1
"7223","10512967",0,4,1,1,0,2
"7224","10512971",0,9,10,17,3,30
"7225","10512973",0,3,0,0,0,0
"7226","10512975",0,2,3,1,0,4
"7227","10513019",0,7,6,4,0,10
"7228","10513036",0,1,0,0,0,0
"7229","10513041",0,4,1,0,0,1
"7230","10513045",0,1,0,0,0,0
"7231","10513053",0,1,0,2,0,2
"7232","10513083",0,6,10,3,0,13
"7233","10513105",0,4,7,1,0,8
"7234","10513148",0,6,6,4,2,12
"7235","10513151",0,4,0,0,0,0
"7236","10513159",0,3,1,0,0,1
"7237","10513163",0,4,1,0,0,1
"7238","10513164",0,4,1,0,0,1
"7239","10513167",0,3,0,0,0,0
"7240","10513171",0,3,2,0,0,2
"7241","10513185",0,5,3,0,0,3
"7242","10513186",0,3,0,1,0,1
"7243","10513308",1,2,0,0,0,0
"7244","10513335",0,1,0,0,0,0
"7245","10513345",0,4,0,0,0,0
"7246","10513386",0,4,0,0,0,0
"7247","10513396",0,3,3,1,0,4
"7248","10513401",0,5,4,2,0,6
"7249","10513418",0,2,0,0,0,0
"7250","10513435",0,2,0,0,0,0
"7251","10513443",0,1,0,0,0,0
"7252","10513449",0,6,4,2,0,6
"7253","10513450",0,3,3,0,0,3
"7254","10513469",0,2,1,0,0,1
"7255","10513494",0,2,0,0,0,0
"7256","10513500",0,5,5,1,0,6
"7257","10513560",0,2,0,2,0,2
"7258","10513575",0,3,0,0,0,0
"7259","10513576",0,2,0,0,0,0
"7260","10513591",0,9,3,6,0,9
"7261","10513659",0,4,6,2,0,8
"7262","10513677",0,3,0,0,0,0
"7263","10513728",0,3,0,0,0,0
"7264","10513731",0,1,0,0,0,0
"7265","10513734",0,2,0,0,0,0
"7266","10513744",1,4,2,1,0,3
"7267","10513745",0,4,0,1,0,1
"7268","10513748",0,5,1,1,0,2
"7269","10513758",0,4,3,0,0,3
"7270","10513775",0,3,0,0,0,0
"7271","10513791",0,5,3,3,0,6
"7272","10513801",0,4,0,0,0,0
"7273","10513844",0,5,1,2,0,3
"7274","10513854",0,3,0,0,0,0
"7275","10513894",0,4,1,4,0,5
"7276","10513903",0,6,7,5,0,12
"7277","10513941",0,3,1,1,0,2
"7278","10513968",0,5,3,1,1,5
"7279","10513976",0,7,6,9,1,16
"7280","10513982",0,4,1,2,0,3
"7281","10513992",0,2,0,1,0,1
"7282","10513995",0,2,0,0,0,0
"7283","10514004",0,3,5,1,0,6
"7284","10514014",0,4,0,0,0,0
"7285","10514027",0,3,0,0,0,0
"7286","10514055",0,5,0,5,1,6
"7287","10514071",0,5,0,0,0,0
"7288","10514119",0,4,0,0,0,0
"7289","10514142",0,4,3,3,0,6
"7290","10514178",0,5,3,1,0,4
"7291","10514206",0,1,0,0,0,0
"7292","10514222",0,3,4,5,0,9
"7293","10514288",0,1,0,0,0,0
"7294","10514294",0,4,0,0,0,0
"7295","10514321",0,2,1,0,0,1
"7296","10514324",0,1,0,0,0,0
"7297","10514386",0,3,2,1,0,3
"7298","10514397",0,1,0,1,0,1
"7299","10514413",0,4,2,1,0,3
"7300","10514414",0,2,0,0,0,0
"7301","10514467",0,6,14,2,0,16
"7302","10514499",0,1,0,0,0,0
"7303","10514516",0,4,0,3,0,3
"7304","10514548",0,6,10,1,0,11
"7305","10514557",0,1,0,0,0,0
"7306","10514576",0,4,0,0,0,0
"7307","10514580",0,4,0,1,0,1
"7308","10514612",0,1,0,0,0,0
"7309","10514628",0,2,1,2,0,3
"7310","10514629",0,2,0,0,0,0
"7311","10514659",0,4,0,0,0,0
"7312","10514665",0,7,1,1,0,2
"7313","10514673",0,6,1,4,0,5
"7314","10514707",0,3,2,0,0,2
"7315","10514712",0,4,1,4,0,5
"7316","10514743",0,3,1,1,0,2
"7317","10514754",0,1,0,0,0,0
"7318","10514767",0,1,0,0,0,0
"7319","10514776",0,1,0,0,0,0
"7320","10514791",0,4,0,0,0,0
"7321","10514845",0,3,0,2,0,2
"7322","10514879",0,4,0,0,0,0
"7323","10514915",0,2,2,0,0,2
"7324","10514988",0,7,5,6,1,12
"7325","10514992",0,6,6,8,2,16
"7326","10515052",0,3,3,0,0,3
"7327","10515064",0,1,0,0,0,0
"7328","10515071",0,1,0,0,0,0
"7329","10515073",0,8,3,11,0,14
"7330","10515093",0,1,0,0,0,0
"7331","10515100",0,2,0,0,0,0
"7332","10515104",0,4,0,0,0,0
"7333","10515122",0,4,1,0,0,1
"7334","10515146",0,5,4,3,1,8
"7335","10515149",0,1,0,1,0,1
"7336","10515151",0,4,2,0,0,2
"7337","10515174",0,4,1,0,1,2
"7338","10515177",0,1,0,0,0,0
"7339","10515211",0,5,8,2,0,10
"7340","10515215",0,1,0,2,0,2
"7341","10515219",0,5,9,12,3,24
"7342","10515232",1,5,0,3,0,3
"7343","10515272",0,3,1,0,0,1
"7344","10515309",0,1,0,0,0,0
"7345","10515311",0,5,3,4,0,7
"7346","10515359",0,3,2,0,0,2
"7347","10515375",0,7,8,0,0,8
"7348","10515394",0,4,1,1,0,2
"7349","10515402",0,4,0,0,0,0
"7350","10515406",0,5,0,0,0,0
"7351","10515419",0,6,3,0,0,3
"7352","10515426",0,7,6,0,0,6
"7353","10515445",0,3,3,1,0,4
"7354","10515463",0,8,9,18,1,28
"7355","10515504",0,3,0,2,0,2
"7356","10515516",0,4,1,2,0,3
"7357","10515518",0,4,1,0,0,1
"7358","10515539",0,5,3,0,0,3
"7359","10515541",0,5,0,0,0,0
"7360","10515571",0,7,9,3,0,12
"7361","10515588",0,4,0,3,0,3
"7362","10515589",0,4,0,7,0,7
"7363","10515598",0,5,2,5,0,7
"7364","10515609",0,4,5,0,0,5
"7365","10515614",0,5,6,4,0,10
"7366","10515631",0,1,0,0,0,0
"7367","10515632",0,1,0,0,0,0
"7368","10515652",0,1,0,0,0,0
"7369","10515655",0,2,0,0,0,0
"7370","10515656",0,4,2,2,0,4
"7371","10515658",0,1,0,0,0,0
"7372","10515661",0,1,0,0,0,0
"7373","10515663",0,4,3,5,0,8
"7374","10515666",0,4,2,0,0,2
"7375","10515728",0,5,9,2,0,11
"7376","10515734",0,3,0,0,0,0
"7377","10515740",0,6,10,1,0,11
"7378","10515796",0,5,6,7,0,13
"7379","10515800",0,5,1,2,0,3
"7380","10515816",0,4,2,1,1,4
"7381","10515913",0,4,0,0,0,0
"7382","10515940",0,1,0,0,0,0
"7383","10515945",0,4,8,1,0,9
"7384","10515979",0,3,6,6,0,12
"7385","10516007",0,4,0,0,0,0
"7386","10516074",0,7,6,6,0,12
"7387","10516089",0,6,2,2,0,4
"7388","10516102",0,8,10,11,0,21
"7389","10516126",0,3,0,1,0,1
"7390","10516149",0,5,4,3,1,8
"7391","10516163",0,5,0,0,0,0
"7392","10516214",0,7,6,5,1,12
"7393","10516222",0,6,5,2,0,7
"7394","10516232",0,1,0,0,0,0
"7395","10516242",0,4,8,7,1,16
"7396","10516281",0,5,7,2,0,9
"7397","10516284",0,4,0,0,0,0
"7398","10516369",0,1,0,0,0,0
"7399","10516376",0,3,0,0,0,0
"7400","10516397",0,5,4,1,0,5
"7401","10516423",0,3,2,0,0,2
"7402","10516465",0,2,1,0,0,1
"7403","10516487",0,3,0,0,0,0
"7404","10516490",0,5,11,1,0,12
"7405","10516491",0,5,2,2,0,4
"7406","10516580",1,5,1,2,0,3
"7407","10516582",1,4,0,1,0,1
"7408","10516588",1,4,0,0,0,0
"7409","10516592",1,3,0,1,0,1
"7410","10516605",0,4,4,1,0,5
"7411","10516606",0,2,0,0,0,0
"7412","10516639",0,4,1,3,0,4
"7413","10516643",0,4,2,1,0,3
"7414","10516690",0,6,8,4,0,12
"7415","10516693",0,1,0,0,0,0
"7416","10516696",0,4,1,1,0,2
"7417","10516708",0,6,6,1,0,7
"7418","10516710",0,1,0,0,0,0
"7419","10516712",0,4,2,2,0,4
"7420","10516714",0,3,0,1,0,1
"7421","10516733",0,4,1,0,0,1
"7422","10516734",0,4,2,2,0,4
"7423","10516744",0,5,10,4,0,14
"7424","10516768",0,4,7,2,0,9
"7425","10516796",0,1,0,0,0,0
"7426","10516831",0,3,0,0,0,0
"7427","10516832",0,8,3,3,0,6
"7428","10516851",0,4,1,3,0,4
"7429","10516873",0,4,1,0,0,1
"7430","10516892",0,10,13,4,0,17
"7431","10516901",1,4,0,3,0,3
"7432","10516915",0,5,5,1,0,6
"7433","10516916",0,3,2,6,0,8
"7434","10516918",0,3,2,1,0,3
"7435","10516935",0,3,0,1,0,1
"7436","10516938",0,5,3,0,0,3
"7437","10516959",0,3,0,2,0,2
"7438","10516960",0,9,8,15,0,23
"7439","10516980",0,2,0,0,0,0
"7440","10516981",0,3,2,0,0,2
"7441","10516984",0,6,3,3,1,7
"7442","10516996",0,4,4,0,0,4
"7443","10516998",0,5,0,1,0,1
"7444","10517002",0,6,0,0,0,0
"7445","10517003",0,6,0,0,0,0
"7446","10517042",0,1,0,0,0,0
"7447","10517199",0,4,2,0,0,2
"7448","10517254",0,5,2,0,0,2
"7449","10517265",0,9,2,5,3,10
"7450","10517373",0,1,0,0,0,0
"7451","10517385",0,2,0,0,0,0
"7452","10517400",0,3,0,0,0,0
"7453","10517409",0,1,0,1,0,1
"7454","10517457",0,3,0,0,0,0
"7455","10517464",0,2,0,1,1,2
"7456","10517488",0,7,8,1,1,10
"7457","10517490",0,6,5,1,0,6
"7458","10517516",0,2,0,0,0,0
"7459","10517524",0,5,4,0,0,4
"7460","10517537",0,4,0,1,0,1
"7461","10517547",0,5,2,0,0,2
"7462","10517554",0,3,5,6,0,11
"7463","10517592",0,4,0,3,0,3
"7464","10517611",0,3,2,1,0,3
"7465","10517613",0,4,4,0,0,4
"7466","10517645",0,6,3,3,1,7
"7467","10517661",0,3,0,1,0,1
"7468","10517708",0,1,0,0,0,0
"7469","10517710",0,2,0,0,0,0
"7470","10517901",1,3,0,0,0,0
"7471","10517923",0,6,6,3,0,9
"7472","10517970",0,1,0,0,0,0
"7473","10517981",0,5,0,1,0,1
"7474","10517982",0,4,0,0,0,0
"7475","10518013",0,1,0,1,0,1
"7476","10518020",0,2,0,0,0,0
"7477","10518034",0,2,1,0,0,1
"7478","10518035",0,4,0,0,0,0
"7479","10518036",0,4,1,4,0,5
"7480","10518044",0,4,0,1,0,1
"7481","10518049",0,7,8,3,0,11
"7482","10518052",0,3,5,4,0,9
"7483","10518054",0,3,0,2,0,2
"7484","10518116",0,7,3,4,1,8
"7485","10518118",0,2,0,0,0,0
"7486","10518120",0,6,7,5,0,12
"7487","10518121",0,2,0,0,0,0
"7488","10518127",0,4,3,2,0,5
"7489","10518133",0,1,0,0,0,0
"7490","10518146",0,4,0,7,0,7
"7491","10518168",0,4,3,4,0,7
"7492","10518170",0,1,0,0,0,0
"7493","10518188",0,2,0,0,0,0
"7494","10518192",0,4,2,1,0,3
"7495","10518194",0,5,1,4,0,5
"7496","10518202",0,2,0,2,0,2
"7497","10518248",0,4,0,0,0,0
"7498","10518257",0,4,0,0,0,0
"7499","10518261",0,8,6,3,0,9
"7500","10518263",0,9,8,7,0,15
"7501","10518269",0,1,0,0,0,0
"7502","10518279",1,6,0,3,0,3
"7503","10518286",0,1,0,0,0,0
"7504","10518294",0,6,3,1,0,4
"7505","10518330",0,5,5,9,0,14
"7506","10518361",0,4,0,0,0,0
"7507","10518367",0,4,7,1,0,8
"7508","10518374",0,3,0,0,0,0
"7509","10518392",0,5,2,4,0,6
"7510","10518393",0,4,0,0,0,0
"7511","10518395",0,1,0,0,0,0
"7512","10518399",0,2,0,0,0,0
"7513","10518539",0,3,1,4,0,5
"7514","10518580",0,10,9,12,1,22
"7515","10518581",0,5,4,2,0,6
"7516","10518594",1,5,6,3,1,10
"7517","10518609",0,3,0,0,0,0
"7518","10518646",0,5,0,0,0,0
"7519","10518660",0,3,0,0,0,0
"7520","10518663",0,3,0,1,0,1
"7521","10518714",0,4,7,6,0,13
"7522","10518792",0,1,0,1,0,1
"7523","10518807",0,4,0,0,0,0
"7524","10518823",0,4,1,0,0,1
"7525","10518829",0,4,3,0,0,3
"7526","10518830",0,4,1,0,0,1
"7527","10518847",0,1,0,1,0,1
"7528","10518848",0,4,4,5,0,9
"7529","10518849",0,6,6,13,2,21
"7530","10518889",0,5,0,1,0,1
"7531","10518895",0,2,0,0,0,0
"7532","10518907",0,2,3,0,0,3
"7533","10518927",0,2,1,1,0,2
"7534","10518936",0,1,0,0,0,0
"7535","10518945",0,5,12,3,0,15
"7536","10518949",0,4,1,3,0,4
"7537","10518956",0,1,1,0,0,1
"7538","10518994",0,4,0,0,0,0
"7539","10518996",0,3,0,0,0,0
"7540","10518997",0,4,1,0,0,1
"7541","10519002",0,2,0,0,0,0
"7542","10519010",0,4,0,0,0,0
"7543","10519017",0,1,0,0,0,0
"7544","10519025",0,4,0,0,0,0
"7545","10519078",0,3,0,0,0,0
"7546","10519116",0,6,1,5,2,8
"7547","10519160",0,3,4,0,0,4
"7548","10519173",0,2,0,0,0,0
"7549","10519206",0,4,2,3,0,5
"7550","10519210",0,5,2,0,0,2
"7551","10519211",0,1,0,1,0,1
"7552","10519216",0,2,0,0,0,0
"7553","10519220",0,4,0,0,0,0
"7554","10519250",0,5,7,2,0,9
"7555","10519256",0,5,2,0,0,2
"7556","10519258",0,4,0,0,0,0
"7557","10519266",0,5,1,3,0,4
"7558","10519301",0,3,0,2,0,2
"7559","10519302",0,4,3,0,0,3
"7560","10519308",0,9,11,4,0,15
"7561","10519321",0,5,5,2,0,7
"7562","10519326",0,4,2,1,0,3
"7563","10519337",0,4,2,2,0,4
"7564","10519347",0,4,0,0,0,0
"7565","10519371",0,3,0,0,0,0
"7566","10519409",0,4,0,0,0,0
"7567","10519410",0,4,1,0,0,1
"7568","10519416",0,5,2,0,0,2
"7569","10519438",0,5,0,0,0,0
"7570","10519448",0,5,1,2,0,3
"7571","10519453",0,1,0,0,0,0
"7572","10519491",0,2,1,2,0,3
"7573","10519495",0,4,0,0,0,0
"7574","10519496",0,4,0,0,0,0
"7575","10519500",0,6,5,12,0,17
"7576","10519501",0,4,6,5,0,11
"7577","10519502",0,4,0,0,0,0
"7578","10519548",0,7,9,2,0,11
"7579","10519554",0,4,1,3,0,4
"7580","10519563",0,4,2,0,0,2
"7581","10519573",0,1,0,0,0,0
"7582","10519578",0,6,0,0,0,0
"7583","10519581",0,3,0,1,0,1
"7584","10519604",0,5,0,0,0,0
"7585","10519654",0,4,0,0,0,0
"7586","10519655",0,1,2,0,0,2
"7587","10519656",0,6,3,2,0,5
"7588","10519710",0,6,2,2,0,4
"7589","10519718",0,1,1,0,0,1
"7590","10519805",0,9,10,8,3,21
"7591","10519841",0,1,0,0,0,0
"7592","10519854",0,3,6,4,0,10
"7593","10519935",0,2,0,0,0,0
"7594","10519940",0,2,0,0,0,0
"7595","10519969",0,6,5,7,0,12
"7596","10520021",0,3,1,0,0,1
"7597","10520023",0,6,1,1,1,3
"7598","10520049",0,3,0,0,0,0
"7599","10520183",0,4,4,0,0,4
"7600","10520196",0,4,2,0,0,2
"7601","10520202",0,5,2,3,0,5
"7602","10520281",0,6,2,5,1,8
"7603","10520311",0,6,5,7,0,12
"7604","10520346",0,3,1,3,0,4
"7605","10520372",0,7,4,3,1,8
"7606","10520480",0,3,0,0,0,0
"7607","10520491",0,5,1,0,0,1
"7608","10520495",0,4,1,7,0,8
"7609","10520531",0,4,2,2,0,4
"7610","10520573",0,1,0,0,0,0
"7611","10520600",0,3,1,4,0,5
"7612","10520630",0,4,0,0,0,0
"7613","10520632",0,8,9,7,3,19
"7614","10520645",0,6,5,1,0,6
"7615","10520652",0,1,0,0,0,0
"7616","10520653",0,6,2,1,0,3
"7617","10520656",0,7,10,7,0,17
"7618","10520676",0,4,0,0,0,0
"7619","10520681",0,6,1,6,0,7
"7620","10520696",0,4,1,3,0,4
"7621","10520730",0,1,0,0,0,0
"7622","10520756",0,2,0,0,0,0
"7623","10520859",0,3,0,0,0,0
"7624","10520860",0,4,0,0,0,0
"7625","10520861",0,6,4,6,0,10
"7626","10520868",0,3,4,2,0,6
"7627","10520877",0,6,3,3,0,6
"7628","10520950",0,7,9,4,0,13
"7629","10520952",0,6,3,1,1,5
"7630","10520957",0,5,3,0,0,3
"7631","10521091",0,1,0,0,0,0
"7632","10521094",0,4,0,0,0,0
"7633","10521276",0,4,0,6,0,6
"7634","10521279",0,7,4,3,0,7
"7635","10521343",0,5,6,1,0,7
"7636","10521360",0,4,0,1,0,1
"7637","10521430",0,3,4,0,0,4
"7638","10521445",0,5,9,1,0,10
"7639","10521464",0,5,1,3,0,4
"7640","10521469",0,4,1,1,0,2
"7641","10521520",0,3,2,1,0,3
"7642","10521547",0,2,0,0,0,0
"7643","10521557",0,1,0,0,0,0
"7644","10521567",0,1,0,0,0,0
"7645","10521582",0,4,0,0,0,0
"7646","10521615",0,1,0,1,0,1
"7647","10521618",0,1,0,0,0,0
"7648","10521636",0,1,0,0,0,0
"7649","10521670",0,4,4,3,0,7
"7650","10521700",0,4,2,2,0,4
"7651","10521714",0,3,1,1,0,2
"7652","10521734",0,6,2,1,0,3
"7653","10521787",0,6,7,4,1,12
"7654","10521808",0,5,1,4,0,5
"7655","10521809",0,3,0,1,0,1
"7656","10521849",0,4,0,0,0,0
"7657","10521914",0,6,4,0,0,4
"7658","10521942",0,5,4,8,0,12
"7659","10521974",0,8,4,2,1,7
"7660","10521980",0,1,0,0,0,0
"7661","10521981",0,5,2,0,0,2
"7662","10521982",0,2,0,0,0,0
"7663","10521983",0,5,5,2,1,8
"7664","10522015",0,1,0,0,0,0
"7665","10522032",0,7,8,3,0,11
"7666","10522109",0,3,2,0,0,2
"7667","10522117",0,5,0,4,0,4
"7668","10522118",0,2,0,0,0,0
"7669","10522120",0,4,0,0,0,0
"7670","10522158",0,3,0,2,0,2
"7671","10522193",0,4,2,3,0,5
"7672","10522214",0,6,2,5,0,7
"7673","10522223",0,7,5,3,0,8
"7674","10522227",1,3,0,1,0,1
"7675","10522260",0,7,5,13,1,19
"7676","10522262",0,3,1,6,0,7
"7677","10522270",0,6,7,11,0,18
"7678","10522275",0,6,1,0,0,1
"7679","10522278",0,2,0,0,0,0
"7680","10522279",0,6,7,7,0,14
"7681","10522280",0,4,1,3,0,4
"7682","10522286",0,7,13,7,0,20
"7683","10522314",0,4,0,0,0,0
"7684","10522317",0,5,0,1,0,1
"7685","10522319",0,1,0,0,0,0
"7686","10522327",0,5,0,0,0,0
"7687","10522338",0,8,16,2,0,18
"7688","10522343",0,6,10,9,1,20
"7689","10522353",0,3,0,0,0,0
"7690","10522357",0,1,0,0,0,0
"7691","10522364",0,6,4,4,1,9
"7692","10522366",0,4,3,0,0,3
"7693","10522388",0,1,0,1,0,1
"7694","10522414",0,6,4,1,0,5
"7695","10522415",0,4,4,0,0,4
"7696","10522417",0,3,4,1,0,5
"7697","10522418",0,2,1,1,0,2
"7698","10522419",0,1,0,0,0,0
"7699","10522420",0,3,0,0,0,0
"7700","10522425",0,1,1,0,0,1
"7701","10522428",0,3,0,0,0,0
"7702","10522432",0,4,4,0,0,4
"7703","10522467",0,3,1,4,0,5
"7704","10522594",1,3,0,0,0,0
"7705","10522634",0,7,12,9,0,21
"7706","10522734",0,5,6,6,0,12
"7707","10522764",0,8,12,4,2,18
"7708","10522766",0,3,0,0,0,0
"7709","10522768",0,1,0,0,0,0
"7710","10522880",0,2,1,2,0,3
"7711","10522882",0,5,3,1,0,4
"7712","10522894",0,1,0,0,0,0
"7713","10522921",0,1,1,0,0,1
"7714","10522938",0,1,0,0,0,0
"7715","10522946",0,4,1,0,0,1
"7716","10522966",0,6,2,1,0,3
"7717","10523000",0,1,0,1,0,1
"7718","10523038",0,4,8,2,0,10
"7719","10523070",0,4,2,0,0,2
"7720","10523132",0,6,12,0,0,12
"7721","10523143",0,6,4,1,0,5
"7722","10523144",0,6,8,4,0,12
"7723","10523159",0,4,3,2,0,5
"7724","10523182",0,4,1,1,0,2
"7725","10523250",0,7,2,1,1,4
"7726","10523325",0,4,8,4,0,12
"7727","10523345",0,2,1,0,0,1
"7728","10523391",0,3,4,4,0,8
"7729","10523392",0,6,8,2,0,10
"7730","10523395",0,3,0,0,0,0
"7731","10523399",0,3,0,0,0,0
"7732","10523406",0,3,0,0,0,0
"7733","10523409",1,5,4,2,1,7
"7734","10523411",0,4,0,0,0,0
"7735","10523413",0,3,0,0,0,0
"7736","10523416",0,2,1,0,0,1
"7737","10523437",0,1,0,0,0,0
"7738","10523438",0,4,5,0,0,5
"7739","10523469",0,5,7,3,0,10
"7740","10523497",0,4,0,0,0,0
"7741","10523584",0,3,4,2,0,6
"7742","10523587",1,5,0,3,0,3
"7743","10523594",0,4,0,1,0,1
"7744","10523600",0,3,0,0,0,0
"7745","10523615",1,4,0,0,0,0
"7746","10523620",0,7,8,3,0,11
"7747","10523637",0,3,2,0,0,2
"7748","10523690",0,3,0,0,0,0
"7749","10523742",1,2,0,1,0,1
"7750","10523774",0,3,0,0,0,0
"7751","10523785",0,8,3,2,2,7
"7752","10523788",0,4,0,0,0,0
"7753","10523804",0,3,2,1,0,3
"7754","10523844",0,5,3,1,0,4
"7755","10523891",0,2,2,0,0,2
"7756","10523915",0,3,2,1,0,3
"7757","10523928",0,7,9,4,1,14
"7758","10523952",0,1,0,0,0,0
"7759","10523990",0,5,0,0,0,0
"7760","10524002",0,3,7,0,0,7
"7761","10524122",0,5,0,0,0,0
"7762","10524142",0,2,0,0,0,0
"7763","10524169",0,4,2,2,0,4
"7764","10524203",0,4,0,0,0,0
"7765","10524246",0,3,3,1,0,4
"7766","10524281",0,4,0,0,0,0
"7767","10524283",0,2,2,0,0,2
"7768","10524296",0,7,12,7,0,19
"7769","10524383",0,6,1,3,0,4
"7770","10524399",0,3,0,1,0,1
"7771","10524440",0,1,1,0,0,1
"7772","10524456",0,3,1,0,0,1
"7773","10524486",0,3,0,0,0,0
"7774","10524491",0,3,0,0,0,0
"7775","10524507",0,4,0,0,0,0
"7776","10524513",0,3,1,2,0,3
"7777","10524517",0,6,0,0,0,0
"7778","10524522",0,4,0,0,0,0
"7779","10524535",0,2,0,0,0,0
"7780","10524547",0,3,1,0,0,1
"7781","10524548",0,2,1,0,0,1
"7782","10524550",0,4,0,1,0,1
"7783","10524631",0,4,5,3,0,8
"7784","10524637",0,4,0,1,0,1
"7785","10524656",0,5,7,1,0,8
"7786","10524668",0,1,0,0,0,0
"7787","10524671",0,3,0,6,0,6
"7788","10524677",0,3,3,2,0,5
"7789","10524697",0,6,4,1,0,5
"7790","10524746",0,5,1,1,0,2
"7791","10524748",0,7,4,3,1,8
"7792","10524749",0,7,5,2,0,7
"7793","10524751",0,5,7,2,0,9
"7794","10524762",0,2,0,0,0,0
"7795","10524818",0,3,0,0,0,0
"7796","10524819",0,5,0,1,0,1
"7797","10524820",0,2,0,0,0,0
"7798","10524823",0,2,1,0,0,1
"7799","10524919",0,6,5,4,0,9
"7800","10524947",0,4,2,0,0,2
"7801","10524961",0,9,17,17,1,35
"7802","10524973",0,4,0,2,0,2
"7803","10525017",0,1,0,0,0,0
"7804","10525047",0,5,0,0,0,0
"7805","10525054",0,4,0,0,0,0
"7806","10525056",0,4,4,2,2,8
"7807","10525060",0,4,5,2,0,7
"7808","10525068",0,5,1,0,0,1
"7809","10525076",0,5,4,1,0,5
"7810","10525087",0,4,3,0,0,3
"7811","10525116",0,7,10,5,0,15
"7812","10525130",0,1,0,0,0,0
"7813","10525137",0,6,1,5,1,7
"7814","10525154",0,5,6,3,2,11
"7815","10525160",0,3,0,1,0,1
"7816","10525179",0,4,4,0,0,4
"7817","10525252",0,5,1,0,0,1
"7818","10525267",0,3,0,0,0,0
"7819","10525286",0,3,1,1,0,2
"7820","10525290",0,5,2,0,0,2
"7821","10525291",0,1,0,0,0,0
"7822","10525299",0,3,0,0,0,0
"7823","10525358",0,1,0,0,0,0
"7824","10525362",0,5,2,1,0,3
"7825","10525363",1,4,0,1,0,1
"7826","10525378",0,1,0,0,0,0
"7827","10525382",0,5,8,2,0,10
"7828","10525386",0,4,3,3,0,6
"7829","10525389",0,5,9,3,0,12
"7830","10525401",0,2,0,0,0,0
"7831","10525408",0,4,0,3,0,3
"7832","10525439",0,5,3,0,0,3
"7833","10525441",0,4,10,4,0,14
"7834","10525442",0,4,2,3,0,5
"7835","10525495",0,5,0,0,0,0
"7836","10525539",0,3,0,0,0,0
"7837","10525552",0,4,0,1,0,1
"7838","10525555",0,10,9,10,1,20
"7839","10525583",0,5,7,3,0,10
"7840","10525618",0,7,8,4,0,12
"7841","10525620",0,4,3,5,1,9
"7842","10525634",0,7,2,5,0,7
"7843","10525655",0,3,1,1,0,2
"7844","10525660",0,3,2,2,1,5
"7845","10525698",0,10,19,6,2,27
"7846","10525708",0,2,0,0,1,1
"7847","10525712",0,8,8,8,0,16
"7848","10525717",0,6,5,0,0,5
"7849","10525721",0,1,0,0,0,0
"7850","10525738",0,6,4,8,0,12
"7851","10525791",0,3,0,1,0,1
"7852","10525800",0,4,2,0,0,2
"7853","10525815",0,1,0,0,0,0
"7854","10525871",0,1,0,0,0,0
"7855","10525872",0,5,0,0,0,0
"7856","10525898",0,4,1,1,0,2
"7857","10525903",0,4,0,0,0,0
"7858","10525907",0,3,2,4,0,6
"7859","10525911",0,6,0,0,0,0
"7860","10525912",0,11,11,11,4,26
"7861","10525918",0,7,2,3,0,5
"7862","10525944",0,6,0,0,0,0
"7863","10525951",0,9,10,9,0,19
"7864","10526065",0,4,6,2,0,8
"7865","10526128",0,4,2,6,1,9
"7866","10526163",0,3,3,3,0,6
"7867","10526169",0,2,0,0,1,1
"7868","10526171",0,4,2,2,0,4
"7869","10526179",0,3,6,1,0,7
"7870","10526181",0,6,13,4,2,19
"7871","10526183",0,8,20,4,0,24
"7872","10526223",0,2,1,0,0,1
"7873","10526232",0,1,0,0,0,0
"7874","10526236",0,6,0,0,0,0
"7875","10526295",1,5,0,0,0,0
"7876","10526433",0,2,0,2,0,2
"7877","10526485",0,4,5,3,0,8
"7878","10526524",1,4,0,0,0,0
"7879","10526525",1,3,1,0,0,1
"7880","10526531",1,4,1,2,0,3
"7881","10526544",0,3,0,0,0,0
"7882","10526564",0,1,0,0,0,0
"7883","10526579",0,11,10,15,4,29
"7884","10526588",1,5,1,1,0,2
"7885","10526653",0,2,1,1,0,2
"7886","10526670",0,5,2,1,0,3
"7887","10526693",0,3,0,0,0,0
"7888","10526709",0,4,5,1,0,6
"7889","10526726",0,2,0,0,0,0
"7890","10526781",0,2,0,0,0,0
"7891","10526792",0,4,6,1,0,7
"7892","10526805",1,5,1,3,0,4
"7893","10526821",0,4,2,0,0,2
"7894","10526825",0,1,0,0,0,0
"7895","10526832",0,4,2,5,0,7
"7896","10526844",0,7,16,5,0,21
"7897","10526902",0,14,27,14,6,47
"7898","10526953",0,5,4,2,0,6
"7899","10526999",0,4,1,0,0,1
"7900","10527011",0,3,0,0,0,0
"7901","10527014",0,4,5,0,0,5
"7902","10527036",0,4,2,1,0,3
"7903","10527038",0,2,0,0,0,0
"7904","10527080",0,4,1,2,0,3
"7905","10527106",0,5,5,3,1,9
"7906","10527108",0,6,11,1,1,13
"7907","10527141",0,5,4,2,0,6
"7908","10527171",0,2,1,0,0,1
"7909","10527172",0,5,1,0,0,1
"7910","10527234",0,7,6,3,1,10
"7911","10527250",0,4,3,0,0,3
"7912","10527254",0,6,4,3,0,7
"7913","10527325",0,1,0,0,0,0
"7914","10527352",0,8,19,15,2,36
"7915","10527354",0,2,1,1,0,2
"7916","10527374",0,4,1,0,0,1
"7917","10527379",0,4,1,0,0,1
"7918","10527542",0,5,1,1,0,2
"7919","10527556",0,5,5,1,0,6
"7920","10527574",0,5,1,0,0,1
"7921","10527579",0,3,1,3,0,4
"7922","10527596",0,4,1,0,0,1
"7923","10527599",0,5,4,3,0,7
"7924","10527626",0,5,7,12,0,19
"7925","10527697",0,1,1,0,0,1
"7926","10527748",1,9,2,0,1,3
"7927","10527761",0,4,1,0,0,1
"7928","10527763",0,2,0,0,0,0
"7929","10527764",0,3,4,6,0,10
"7930","10527826",0,7,6,8,1,15
"7931","10527897",0,8,11,7,1,19
"7932","10527902",0,3,0,0,0,0
"7933","10527918",0,4,1,2,0,3
"7934","10527946",0,3,4,0,0,4
"7935","10527948",0,4,0,2,0,2
"7936","10527949",0,8,5,6,0,11
"7937","10527963",0,4,2,4,0,6
"7938","10527986",0,3,2,2,0,4
"7939","10527987",0,4,0,0,0,0
"7940","10528011",0,5,2,0,0,2
"7941","10528104",0,4,0,0,0,0
"7942","10528105",0,2,1,0,0,1
"7943","10528107",0,4,5,1,0,6
"7944","10528115",0,1,0,0,0,0
"7945","10528120",0,5,2,7,1,10
"7946","10528125",0,5,1,0,0,1
"7947","10528136",0,5,0,2,0,2
"7948","10528173",0,6,4,1,0,5
"7949","10528216",0,7,5,1,0,6
"7950","10528234",1,4,0,2,0,2
"7951","10528245",0,4,1,4,0,5
"7952","10528246",0,5,5,5,0,10
"7953","10528248",0,2,1,0,0,1
"7954","10528253",0,3,3,4,0,7
"7955","10528254",0,11,19,19,1,39
"7956","10528271",0,5,0,1,0,1
"7957","10528274",0,4,6,1,0,7
"7958","10528281",0,4,1,0,0,1
"7959","10528287",0,5,3,4,0,7
"7960","10528296",0,1,1,0,0,1
"7961","10528297",0,2,0,0,0,0
"7962","10528444",0,2,4,2,0,6
"7963","10528488",0,5,3,4,2,9
"7964","10528526",0,4,5,0,0,5
"7965","10528539",0,3,1,1,0,2
"7966","10528540",0,6,2,0,0,2
"7967","10528556",0,5,3,0,0,3
"7968","10528579",0,8,3,1,0,4
"7969","10528587",0,5,6,2,0,8
"7970","10528606",0,2,0,0,0,0
"7971","10528626",0,4,11,1,0,12
"7972","10528631",0,4,0,0,0,0
"7973","10528642",0,4,0,0,0,0
"7974","10528649",0,2,0,0,0,0
"7975","10528695",0,5,0,0,0,0
"7976","10528703",0,4,5,0,0,5
"7977","10528706",0,5,3,0,1,4
"7978","10528712",0,1,2,1,0,3
"7979","10528718",0,3,0,0,0,0
"7980","10528722",0,4,4,0,0,4
"7981","10528763",0,4,0,0,0,0
"7982","10528809",0,1,0,0,0,0
"7983","10528825",0,3,0,0,0,0
"7984","10528834",0,2,0,0,0,0
"7985","10528843",0,4,2,3,0,5
"7986","10528862",0,2,1,0,0,1
"7987","10528888",0,5,2,0,0,2
"7988","10528914",0,3,0,1,0,1
"7989","10528955",0,3,7,0,0,7
"7990","10528960",0,6,2,3,0,5
"7991","10528963",0,3,0,0,0,0
"7992","10528970",0,1,0,0,0,0
"7993","10528999",0,5,1,2,0,3
"7994","10529003",0,5,12,4,1,17
"7995","10529012",0,4,4,2,0,6
"7996","10529041",0,2,3,1,0,4
"7997","10529118",0,5,1,1,0,2
"7998","10529139",0,4,0,0,0,0
"7999","10529191",0,4,7,5,1,13
"8000","10529310",0,6,0,0,0,0
"8001","10529323",0,4,1,1,0,2
"8002","10529326",0,7,2,2,0,4
"8003","10529343",0,4,2,0,0,2
"8004","10529351",0,2,0,0,0,0
"8005","10529437",0,3,1,1,0,2
"8006","10529474",0,3,0,0,0,0
"8007","10529483",0,4,0,0,0,0
"8008","10529484",0,8,7,5,0,12
"8009","10529489",0,6,3,6,0,9
"8010","10529490",0,1,0,0,0,0
"8011","10529492",0,6,3,5,0,8
"8012","10529507",0,8,8,6,4,18
"8013","10529570",0,7,2,5,1,8
"8014","10529577",0,6,3,4,0,7
"8015","10529579",0,3,6,3,0,9
"8016","10529599",0,2,2,1,0,3
"8017","10529614",0,4,2,3,0,5
"8018","10529615",0,4,1,3,0,4
"8019","10529622",0,1,0,0,0,0
"8020","10529637",0,6,6,3,2,11
"8021","10529673",0,3,0,0,0,0
"8022","10529692",0,5,5,3,0,8
"8023","10529709",0,4,0,0,0,0
"8024","10529734",0,5,1,0,0,1
"8025","10529790",0,4,0,0,0,0
"8026","10529879",0,1,0,0,0,0
"8027","10529898",0,1,1,0,0,1
"8028","10529930",0,1,0,0,0,0
"8029","10529972",0,3,2,4,0,6
"8030","10530036",0,4,0,2,0,2
"8031","10530060",0,9,7,4,0,11
"8032","10530080",0,5,6,5,0,11
"8033","10530082",0,1,0,2,0,2
"8034","10530086",0,6,9,7,1,17
"8035","10530095",0,6,2,4,0,6
"8036","10530108",0,1,0,0,0,0
"8037","10530128",0,5,1,2,1,4
"8038","10530192",0,3,0,1,0,1
"8039","10530195",0,8,6,4,1,11
"8040","10530226",0,5,4,6,0,10
"8041","10530288",0,3,0,0,0,0
"8042","10530344",0,4,0,0,0,0
"8043","10530348",0,6,9,2,1,12
"8044","10530425",0,4,4,3,0,7
"8045","10530465",0,4,0,0,0,0
"8046","10530473",0,5,3,3,0,6
"8047","10530485",0,1,0,0,0,0
"8048","10530491",0,4,2,0,0,2
"8049","10530517",0,8,4,8,1,13
"8050","10530545",0,2,0,0,0,0
"8051","10530683",1,4,1,2,0,3
"8052","10530733",0,1,0,0,0,0
"8053","10530814",0,5,1,3,0,4
"8054","10530864",0,4,2,0,0,2
"8055","10530882",0,4,1,0,0,1
"8056","10530888",0,6,4,2,1,7
"8057","10530921",0,3,8,4,0,12
"8058","10530937",0,3,3,0,0,3
"8059","10530962",0,4,4,2,0,6
"8060","10530997",0,4,0,0,0,0
"8061","10531003",0,4,2,2,0,4
"8062","10531012",0,3,1,1,0,2
"8063","10531016",0,3,0,0,0,0
"8064","10531037",0,5,9,1,0,10
"8065","10531044",1,4,0,0,0,0
"8066","10531045",1,4,4,1,0,5
"8067","10531046",1,3,0,0,0,0
"8068","10531047",1,3,1,1,0,2
"8069","10531048",1,3,1,1,0,2
"8070","10531049",1,3,0,0,0,0
"8071","10531051",1,3,0,0,0,0
"8072","10531052",1,3,0,0,0,0
"8073","10531060",0,3,3,0,0,3
"8074","10531069",0,3,1,0,0,1
"8075","10531071",0,1,0,0,0,0
"8076","10531073",0,4,2,1,0,3
"8077","10531076",0,1,0,0,0,0
"8078","10531101",0,4,1,0,0,1
"8079","10531115",0,4,2,0,0,2
"8080","10531186",0,3,1,3,0,4
"8081","10531224",0,2,0,0,0,0
"8082","10531337",0,3,3,1,0,4
"8083","10531372",0,3,1,0,0,1
"8084","10531374",0,4,0,0,0,0
"8085","10531378",0,4,3,1,0,4
"8086","10531386",0,4,1,0,0,1
"8087","10531420",0,5,0,0,0,0
"8088","10531453",0,4,0,2,0,2
"8089","10531508",0,4,0,0,0,0
"8090","10531562",0,2,0,0,0,0
"8091","10531569",0,3,0,0,0,0
"8092","10531573",0,14,20,20,3,43
"8093","10531604",0,7,4,4,2,10
"8094","10531605",0,4,0,0,0,0
"8095","10531610",0,4,0,1,0,1
"8096","10531635",0,5,4,1,0,5
"8097","10531636",0,4,3,2,0,5
"8098","10531656",0,5,2,5,0,7
"8099","10531658",0,2,1,2,0,3
"8100","10531667",0,3,1,1,0,2
"8101","10531672",0,5,7,1,0,8
"8102","10531686",0,1,1,2,0,3
"8103","10531688",0,4,0,0,0,0
"8104","10531693",0,7,4,12,2,18
"8105","10531720",0,4,2,5,0,7
"8106","10531735",0,5,2,7,1,10
"8107","10531737",0,1,0,0,0,0
"8108","10531746",0,3,0,0,0,0
"8109","10531747",0,1,0,0,0,0
"8110","10531748",0,3,0,0,0,0
"8111","10531749",0,3,1,0,0,1
"8112","10531750",0,2,0,0,0,0
"8113","10531756",0,3,0,0,0,0
"8114","10531759",0,1,0,0,0,0
"8115","10531762",0,3,1,0,0,1
"8116","10531764",0,3,1,0,0,1
"8117","10531765",0,3,1,0,0,1
"8118","10531774",0,2,1,4,0,5
"8119","10531811",0,3,1,1,0,2
"8120","10531821",0,2,0,0,0,0
"8121","10531920",0,2,0,0,0,0
"8122","10531971",0,6,3,3,2,8
"8123","10531972",0,4,0,1,0,1
"8124","10532026",0,3,0,0,0,0
"8125","10532075",0,2,0,0,0,0
"8126","10532080",0,1,0,0,0,0
"8127","10532082",0,4,3,3,0,6
"8128","10532113",0,6,3,10,0,13
"8129","10532123",0,1,2,2,0,4
"8130","10532124",0,3,0,2,0,2
"8131","10532126",0,2,0,2,0,2
"8132","10532143",0,3,0,0,0,0
"8133","10532217",0,5,9,8,1,18
"8134","10532218",0,4,6,1,0,7
"8135","10532220",0,4,0,0,0,0
"8136","10532221",0,1,0,0,0,0
"8137","10532227",0,5,1,1,0,2
"8138","10532229",0,4,3,0,0,3
"8139","10532235",0,1,0,0,0,0
"8140","10532236",0,4,1,0,0,1
"8141","10532261",0,4,1,9,0,10
"8142","10532321",0,4,5,0,0,5
"8143","10532324",0,5,3,3,0,6
"8144","10532393",0,1,0,0,0,0
"8145","10532449",0,5,0,0,0,0
"8146","10532451",0,4,0,0,0,0
"8147","10532462",0,4,1,4,0,5
"8148","10532502",0,6,6,5,3,14
"8149","10532520",0,2,1,0,0,1
"8150","10532533",0,5,8,1,0,9
"8151","10532561",0,3,7,0,0,7
"8152","10532562",0,1,0,0,0,0
"8153","10532563",0,5,0,0,0,0
"8154","10532596",0,4,1,2,0,3
"8155","10532602",0,4,0,0,0,0
"8156","10532606",0,3,0,0,0,0
"8157","10532608",0,1,1,0,0,1
"8158","10532641",0,2,0,0,0,0
"8159","10532665",0,4,6,1,0,7
"8160","10532680",0,3,1,1,0,2
"8161","10532717",0,4,0,0,0,0
"8162","10532721",0,6,5,3,0,8
"8163","10532803",0,3,1,2,0,3
"8164","10532805",0,3,0,0,0,0
"8165","10532810",0,4,2,1,0,3
"8166","10532883",0,4,3,0,0,3
"8167","10532888",0,4,0,0,0,0
"8168","10532946",0,5,7,6,1,14
"8169","10532974",0,1,1,1,0,2
"8170","10533000",0,4,5,5,0,10
"8171","10533007",0,5,0,0,0,0
"8172","10533011",0,6,1,1,0,2
"8173","10533073",0,3,2,0,0,2
"8174","10533076",0,2,0,0,0,0
"8175","10533092",0,2,1,0,0,1
"8176","10533095",0,2,0,0,0,0
"8177","10533098",0,4,1,1,0,2
"8178","10533133",0,4,0,3,0,3
"8179","10533200",0,6,4,5,0,9
"8180","10533279",0,3,1,6,0,7
"8181","10533296",1,2,0,0,0,0
"8182","10533299",0,2,0,0,0,0
"8183","10533311",0,4,4,3,0,7
"8184","10533329",0,4,0,1,0,1
"8185","10533335",0,3,1,2,0,3
"8186","10533338",0,5,9,8,0,17
"8187","10533346",0,6,4,9,0,13
"8188","10533350",0,4,9,4,0,13
"8189","10533361",0,4,7,1,0,8
"8190","10533371",0,1,1,1,0,2
"8191","10533386",0,4,2,3,0,5
"8192","10533391",0,2,1,4,0,5
"8193","10533393",0,2,1,3,0,4
"8194","10533423",0,4,1,0,0,1
"8195","10533460",0,3,0,0,0,0
"8196","10533472",0,3,2,1,0,3
"8197","10533519",0,3,1,0,0,1
"8198","10533530",0,2,4,4,0,8
"8199","10533756",0,4,1,2,0,3
"8200","10533759",0,1,0,0,0,0
"8201","10533813",0,1,0,0,0,0
"8202","10533830",0,6,10,3,0,13
"8203","10533831",0,1,0,0,0,0
"8204","10533836",0,4,6,3,0,9
"8205","10533846",0,5,1,2,1,4
"8206","10533852",0,1,0,2,0,2
"8207","10533964",0,4,0,4,0,4
"8208","10533969",0,1,0,0,0,0
"8209","10533988",0,2,0,0,0,0
"8210","10534023",0,1,2,0,0,2
"8211","10534027",0,7,6,1,0,7
"8212","10534060",0,6,6,6,2,14
"8213","10534073",0,7,5,5,0,10
"8214","10534078",0,5,2,8,0,10
"8215","10534091",0,5,6,3,0,9
"8216","10534096",0,4,1,5,0,6
"8217","10534098",0,3,0,1,0,1
"8218","10534100",0,1,0,0,0,0
"8219","10534110",0,2,1,1,0,2
"8220","10534126",0,4,8,1,0,9
"8221","10534139",0,4,0,0,0,0
"8222","10534177",0,3,1,0,0,1
"8223","10534201",0,1,0,0,0,0
"8224","10534210",0,1,0,0,0,0
"8225","10534264",0,2,0,0,0,0
"8226","10534413",0,3,1,1,0,2
"8227","10534432",1,6,0,0,0,0
"8228","10534438",0,4,5,4,0,9
"8229","10534562",0,1,0,0,0,0
"8230","10534651",0,3,0,0,0,0
"8231","10534799",0,2,0,0,0,0
"8232","10534818",0,3,2,0,0,2
"8233","10534838",0,3,1,1,0,2
"8234","10534841",0,1,0,0,0,0
"8235","10534847",0,5,0,0,0,0
"8236","10534850",0,1,0,0,0,0
"8237","10534895",0,5,3,5,0,8
"8238","10534997",0,3,0,0,0,0
"8239","10535014",0,4,3,0,0,3
"8240","10535016",0,4,3,0,0,3
"8241","10535019",0,3,4,0,0,4
"8242","10535022",0,5,6,10,0,16
"8243","10535072",0,3,2,0,0,2
"8244","10535074",0,3,3,2,0,5
"8245","10535075",0,1,0,0,0,0
"8246","10535131",0,4,1,0,0,1
"8247","10535140",1,4,0,1,0,1
"8248","10535150",0,3,0,0,0,0
"8249","10535176",0,4,2,1,0,3
"8250","10535178",0,5,8,3,1,12
"8251","10535179",0,6,4,3,2,9
"8252","10535191",0,3,0,0,0,0
"8253","10535193",0,3,0,0,0,0
"8254","10535211",0,3,0,0,0,0
"8255","10535217",0,4,0,0,0,0
"8256","10535277",0,4,0,1,0,1
"8257","10535280",0,5,6,2,0,8
"8258","10535301",0,3,0,0,0,0
"8259","10535303",0,3,6,2,0,8
"8260","10535321",0,1,0,0,0,0
"8261","10535480",0,2,1,0,0,1
"8262","10535507",1,6,1,2,0,3
"8263","10535537",0,5,1,4,0,5
"8264","10535565",0,2,0,0,0,0
"8265","10535659",0,5,5,1,0,6
"8266","10535670",0,3,1,0,0,1
"8267","10535671",0,3,0,1,0,1
"8268","10535675",0,1,0,0,0,0
"8269","10535691",0,2,2,2,0,4
"8270","10535768",0,4,2,1,0,3
"8271","10535851",0,3,1,0,0,1
"8272","10535854",0,4,2,3,0,5
"8273","10535856",0,1,0,0,0,0
"8274","10535860",0,4,8,0,0,8
"8275","10535862",0,3,0,0,0,0
"8276","10535867",0,4,3,6,1,10
"8277","10535904",0,4,5,1,0,6
"8278","10535956",0,12,16,24,4,44
"8279","10535960",0,1,0,0,0,0
"8280","10535961",0,5,3,0,0,3
"8281","10535963",0,5,3,3,0,6
"8282","10535974",0,4,0,0,0,0
"8283","10536029",0,4,3,0,0,3
"8284","10536042",1,3,1,0,0,1
"8285","10536123",0,1,0,0,0,0
"8286","10536150",0,1,0,0,0,0
"8287","10536155",0,5,2,3,0,5
"8288","10536156",0,9,12,6,1,19
"8289","10536159",0,5,0,0,0,0
"8290","10536175",0,1,0,2,0,2
"8291","10536190",0,4,5,1,0,6
"8292","10536209",0,2,1,1,0,2
"8293","10536250",0,1,0,0,0,0
"8294","10536261",0,9,9,3,2,14
"8295","10536292",0,2,2,0,0,2
"8296","10536303",0,6,3,4,0,7
"8297","10536332",0,3,1,1,0,2
"8298","10536338",0,5,4,4,0,8
"8299","10536340",0,4,4,2,0,6
"8300","10536368",0,12,15,17,4,36
"8301","10536463",0,6,6,1,2,9
"8302","10536465",0,5,3,2,0,5
"8303","10536480",0,2,1,0,0,1
"8304","10536511",0,2,0,0,0,0
"8305","10536527",0,3,0,0,0,0
"8306","10536633",0,3,4,1,0,5
"8307","10536676",0,4,3,1,0,4
"8308","10536714",0,6,6,3,0,9
"8309","10536741",0,6,4,3,0,7
"8310","10536744",0,6,8,2,0,10
"8311","10536784",0,3,0,0,0,0
"8312","10536790",0,4,1,0,0,1
"8313","10536791",0,4,4,0,0,4
"8314","10536795",0,2,0,0,0,0
"8315","10536799",0,1,0,0,0,0
"8316","10536801",0,1,0,0,0,0
"8317","10536860",0,7,6,1,0,7
"8318","10536861",0,7,2,0,0,2
"8319","10536891",0,3,2,4,0,6
"8320","10536922",0,4,5,1,0,6
"8321","10536923",0,5,5,3,0,8
"8322","10536929",0,5,10,3,0,13
"8323","10536930",0,3,1,0,0,1
"8324","10536934",0,2,4,1,0,5
"8325","10536978",1,6,0,4,2,6
"8326","10537089",0,2,1,0,0,1
"8327","10537108",0,3,0,0,0,0
"8328","10537111",0,3,0,0,0,0
"8329","10537117",0,6,0,3,0,3
"8330","10537123",0,2,3,0,0,3
"8331","10537124",0,3,0,0,0,0
"8332","10537131",0,6,5,5,0,10
"8333","10537132",0,6,11,5,2,18
"8334","10537134",0,4,3,4,0,7
"8335","10537173",0,5,0,0,0,0
"8336","10537178",0,4,7,6,2,15
"8337","10537326",0,5,8,0,0,8
"8338","10537389",0,7,7,4,0,11
"8339","10537449",0,4,1,1,0,2
"8340","10537497",0,6,0,0,0,0
"8341","10537524",0,3,0,0,0,0
"8342","10537577",0,5,8,4,3,15
"8343","10537598",0,4,5,0,0,5
"8344","10537641",0,2,0,0,0,0
"8345","10537719",0,2,0,0,0,0
"8346","10537741",0,5,3,3,0,6
"8347","10537784",0,9,11,8,5,24
"8348","10537870",0,4,0,0,0,0
"8349","10537926",0,5,1,0,0,1
"8350","10538038",0,7,6,3,0,9
"8351","10538065",0,5,5,0,0,5
"8352","10538069",0,8,1,3,2,6
"8353","10538078",0,5,4,0,0,4
"8354","10538137",0,4,1,1,0,2
"8355","10538183",1,2,0,0,0,0
"8356","10538254",0,5,0,0,0,0
"8357","10538270",0,6,4,4,0,8
"8358","10538285",0,3,1,0,0,1
"8359","10538299",0,6,3,6,0,9
"8360","10538364",0,7,2,3,1,6
"8361","10538384",0,2,0,0,0,0
"8362","10538404",0,4,1,0,0,1
"8363","10538509",0,4,1,0,0,1
"8364","10538546",0,4,0,0,0,0
"8365","10538683",0,4,0,0,0,0
"8366","10538733",0,4,7,1,0,8
"8367","10538815",0,2,1,1,0,2
"8368","10538863",0,3,2,0,0,2
"8369","10538866",0,5,1,7,0,8
"8370","10538886",0,7,6,2,0,8
"8371","10538930",0,6,6,16,2,24
"8372","10538931",0,4,5,0,0,5
"8373","10538941",0,4,6,8,1,15
"8374","10538951",1,4,0,1,0,1
"8375","10539008",1,7,6,11,5,22
"8376","10539020",0,8,6,6,0,12
"8377","10539161",0,4,0,0,0,0
"8378","10539166",0,5,5,4,3,12
"8379","10539177",0,2,0,1,0,1
"8380","10539189",0,8,8,16,0,24
"8381","10539251",0,6,0,1,0,1
"8382","10539264",0,2,3,2,0,5
"8383","10539276",0,1,0,0,0,0
"8384","10539311",0,13,21,18,6,45
"8385","10539372",0,2,0,0,0,0
"8386","10539401",0,2,1,0,0,1
"8387","10539455",0,7,5,7,0,12
"8388","10539471",0,3,1,1,0,2
"8389","10539475",0,7,3,8,2,13
"8390","10539487",0,6,4,7,1,12
"8391","10539500",0,2,0,0,0,0
"8392","10539539",0,6,5,3,0,8
"8393","10539541",0,4,0,0,0,0
"8394","10539580",0,4,6,2,0,8
"8395","10539613",0,5,0,0,0,0
"8396","10539632",0,5,10,8,1,19
"8397","10539697",0,5,4,5,1,10
"8398","10539705",0,5,6,0,0,6
"8399","10539817",0,3,2,1,0,3
"8400","10539887",0,3,0,1,0,1
"8401","10539891",1,4,1,0,0,1
"8402","10539970",0,6,0,0,0,0
"8403","10540023",0,8,7,6,0,13
"8404","10540054",0,6,1,0,0,1
"8405","10540088",0,2,0,0,0,0
"8406","10540098",0,4,5,4,0,9
"8407","10540137",0,6,4,4,0,8
"8408","10540218",0,2,0,0,0,0
"8409","10540252",0,4,0,2,0,2
"8410","10540304",0,2,0,0,0,0
"8411","10540321",0,4,6,0,0,6
"8412","10540334",0,7,11,6,0,17
"8413","10540376",0,7,8,0,1,9
"8414","10540379",0,6,1,2,0,3
"8415","10540410",0,1,0,0,0,0
"8416","10540419",0,6,0,0,0,0
"8417","10540481",0,7,10,5,0,15
"8418","10540501",0,4,0,0,0,0
"8419","10540530",0,6,1,1,0,2
"8420","10540649",0,3,1,2,0,3
"8421","10540660",0,9,6,8,0,14
"8422","10540708",0,5,2,0,0,2
"8423","10540737",0,4,3,0,0,3
"8424","10540758",0,2,3,1,0,4
"8425","10540775",0,4,1,0,0,1
"8426","10540787",0,1,3,1,0,4
"8427","10540889",0,4,0,0,0,0
"8428","10540957",0,2,1,1,0,2
"8429","10540962",0,4,0,0,0,0
"8430","10541010",0,6,11,7,0,18
"8431","10541044",0,5,3,0,0,3
"8432","10541045",0,8,5,4,1,10
"8433","10541046",0,3,4,1,0,5
"8434","10541074",0,4,0,5,0,5
"8435","10541119",0,2,0,0,0,0
"8436","10541126",0,5,1,1,0,2
"8437","10541159",0,5,2,0,0,2
"8438","10541162",0,8,11,7,0,18
"8439","10541197",0,5,1,0,0,1
"8440","10541228",0,4,1,4,0,5
"8441","10541239",0,4,0,0,0,0
"8442","10541310",0,6,3,6,0,9
"8443","10541344",0,3,3,3,0,6
"8444","10541348",0,1,0,0,0,0
"8445","10541363",0,3,3,0,0,3
"8446","10541396",0,1,0,0,0,0
"8447","10541412",0,4,1,0,0,1
"8448","10541463",0,3,1,0,0,1
"8449","10541476",0,5,1,7,1,9
"8450","10541496",0,7,6,4,0,10
"8451","10541528",1,6,1,3,0,4
"8452","10541530",1,5,3,2,0,5
"8453","10541570",0,5,3,7,1,11
"8454","10541572",0,5,0,2,0,2
"8455","10541573",0,5,0,3,0,3
"8456","10541617",0,9,7,4,0,11
"8457","10541622",0,6,8,5,0,13
"8458","10541624",0,5,1,1,0,2
"8459","10541643",0,5,7,5,0,12
"8460","10541652",0,5,4,1,0,5
"8461","10541670",0,4,2,1,0,3
"8462","10541717",0,5,5,4,0,9
"8463","10541723",0,4,3,4,0,7
"8464","10541731",0,1,0,0,0,0
"8465","10541799",0,3,0,0,0,0
"8466","10541831",0,4,2,2,0,4
"8467","10541933",0,3,1,1,0,2
"8468","10541960",0,6,1,6,0,7
"8469","10541966",1,4,2,0,0,2
"8470","10541992",0,1,0,0,0,0
"8471","10541993",1,2,0,0,0,0
"8472","10542031",0,6,0,6,1,7
"8473","10542098",0,5,0,0,0,0
"8474","10542108",0,5,0,0,0,0
"8475","10542110",0,4,2,0,0,2
"8476","10542221",0,5,1,6,0,7
"8477","10542226",0,5,1,3,1,5
"8478","10542252",0,2,0,0,0,0
"8479","10542264",0,3,1,2,0,3
"8480","10542294",0,2,3,0,0,3
"8481","10542310",0,5,0,1,0,1
"8482","10542385",0,4,0,0,0,0
"8483","10542493",0,3,1,0,0,1
"8484","10542542",0,1,1,0,0,1
"8485","10542556",0,6,8,5,2,15
"8486","10542558",0,4,3,3,0,6
"8487","10542559",0,9,12,19,3,34
"8488","10542574",1,1,1,3,0,4
"8489","10542672",0,3,0,0,0,0
"8490","10542689",0,2,0,0,0,0
"8491","10542695",0,4,0,4,0,4
"8492","10542708",0,9,7,9,3,19
"8493","10542732",0,5,0,0,0,0
"8494","10542739",0,6,3,6,0,9
"8495","10542757",0,6,1,5,0,6
"8496","10542811",0,4,0,2,0,2
"8497","10542839",0,4,6,1,0,7
"8498","10542868",0,4,4,1,0,5
"8499","10542887",0,5,4,1,0,5
"8500","10542888",0,7,0,3,0,3
"8501","10542895",1,5,1,1,0,2
"8502","10542896",0,2,1,3,0,4
"8503","10542947",0,3,0,0,0,0
"8504","10542969",0,4,0,0,0,0
"8505","10543005",0,3,0,0,0,0
"8506","10543006",0,2,0,1,0,1
"8507","10543038",0,1,0,0,0,0
"8508","10543051",0,2,0,1,0,1
"8509","10543055",0,2,4,5,0,9
"8510","10543093",0,6,0,0,0,0
"8511","10543101",0,3,0,0,0,0
"8512","10543196",0,4,0,0,0,0
"8513","10543234",0,6,9,10,5,24
"8514","10543262",0,2,0,0,0,0
"8515","10543295",0,3,1,0,0,1
"8516","10543299",0,6,6,4,0,10
"8517","10543306",0,4,0,3,0,3
"8518","10543341",0,6,7,5,0,12
"8519","10543431",0,2,0,1,0,1
"8520","10543437",0,2,0,0,0,0
"8521","10543468",0,3,0,0,0,0
"8522","10543481",0,3,0,0,0,0
"8523","10543487",0,6,0,0,0,0
"8524","10543491",0,6,1,1,0,2
"8525","10543499",0,6,0,0,0,0
"8526","10543507",0,2,0,0,0,0
"8527","10543511",0,2,0,0,0,0
"8528","10543514",0,2,0,0,0,0
"8529","10543518",0,4,0,0,0,0
"8530","10543522",0,5,4,3,0,7
"8531","10543546",0,4,0,0,0,0
"8532","10543572",0,5,0,0,0,0
"8533","10543597",0,8,8,18,3,29
"8534","10543601",0,4,0,0,0,0
"8535","10543611",0,7,4,8,0,12
"8536","10543612",0,7,0,0,0,0
"8537","10543617",0,2,0,0,0,0
"8538","10543618",0,4,1,0,0,1
"8539","10543621",0,5,2,0,0,2
"8540","10543624",0,3,3,0,0,3
"8541","10543631",0,3,1,0,0,1
"8542","10543653",0,4,4,1,0,5
"8543","10543658",0,2,2,0,0,2
"8544","10543666",0,3,1,0,0,1
"8545","10543670",0,2,0,0,0,0
"8546","10543676",0,4,0,0,0,0
"8547","10543714",0,2,2,1,0,3
"8548","10543722",0,3,0,0,0,0
"8549","10543784",0,4,2,0,0,2
"8550","10543822",0,6,6,6,0,12
"8551","10543881",0,6,1,1,1,3
"8552","10543886",0,4,0,0,0,0
"8553","10543971",0,4,0,2,0,2
"8554","10543985",0,4,2,0,0,2
"8555","10543992",0,7,11,7,2,20
"8556","10544001",0,5,2,0,0,2
"8557","10544013",0,5,3,7,0,10
"8558","10544015",0,1,0,0,0,0
"8559","10544016",0,2,3,0,0,3
"8560","10544022",0,4,0,0,0,0
"8561","10544045",0,7,4,6,0,10
"8562","10544047",0,4,7,1,0,8
"8563","10544078",0,3,1,0,0,1
"8564","10544092",0,7,5,8,2,15
"8565","10544108",0,2,0,0,0,0
"8566","10544116",0,3,1,1,0,2
"8567","10544131",0,4,1,1,0,2
"8568","10544133",0,1,2,0,0,2
"8569","10544135",0,7,4,5,1,10
"8570","10544151",0,3,0,0,0,0
"8571","10544152",0,4,0,0,0,0
"8572","10544171",0,2,0,0,0,0
"8573","10544177",0,3,0,0,0,0
"8574","10544178",0,2,0,1,0,1
"8575","10544180",0,5,4,12,0,16
"8576","10544186",0,3,1,0,0,1
"8577","10544221",0,4,0,1,0,1
"8578","10544223",0,2,0,2,0,2
"8579","10544224",0,5,1,0,0,1
"8580","10544234",0,4,0,0,0,0
"8581","10544239",0,2,0,0,0,0
"8582","10544242",0,4,2,1,0,3
"8583","10544243",0,3,3,0,0,3
"8584","10544245",0,7,7,4,0,11
"8585","10544248",0,2,0,0,0,0
"8586","10544260",0,4,5,2,0,7
"8587","10544272",0,4,1,0,0,1
"8588","10544275",0,7,8,8,2,18
"8589","10544295",0,3,0,0,0,0
"8590","10544302",0,3,0,0,0,0
"8591","10544355",0,3,1,2,0,3
"8592","10544362",0,3,0,1,0,1
"8593","10544367",0,4,2,0,0,2
"8594","10544372",0,4,0,1,0,1
"8595","10544393",0,5,0,0,0,0
"8596","10544417",0,4,1,1,0,2
"8597","10544456",0,5,2,3,0,5
"8598","10544482",0,4,1,2,0,3
"8599","10544487",0,6,6,2,1,9
"8600","10544570",0,2,3,0,0,3
"8601","10544572",0,2,0,0,0,0
"8602","10544576",0,3,4,2,0,6
"8603","10544579",0,4,1,0,0,1
"8604","10544582",0,2,0,0,0,0
"8605","10544584",0,2,0,0,0,0
"8606","10544585",0,2,0,0,0,0
"8607","10544597",0,1,0,0,0,0
"8608","10544601",0,5,7,2,0,9
"8609","10544606",0,2,0,0,0,0
"8610","10544621",0,3,1,1,0,2
"8611","10544633",0,2,1,0,0,1
"8612","10544654",0,2,0,1,0,1
"8613","10544659",0,4,0,0,0,0
"8614","10544680",0,3,2,0,0,2
"8615","10544692",0,4,0,0,0,0
"8616","10544725",0,4,3,1,0,4
"8617","10544772",0,5,5,1,0,6
"8618","10544778",0,2,0,0,0,0
"8619","10544799",0,4,1,0,0,1
"8620","10544828",0,5,4,6,0,10
"8621","10544842",0,4,0,0,0,0
"8622","10544849",0,3,1,3,0,4
"8623","10544883",0,6,11,5,0,16
"8624","10544893",0,5,2,1,0,3
"8625","10544903",0,6,3,9,1,13
"8626","10544906",0,4,0,0,0,0
"8627","10544910",0,3,2,4,0,6
"8628","10544914",0,10,19,8,0,27
"8629","10544916",0,2,1,1,0,2
"8630","10544917",0,5,2,2,0,4
"8631","10544923",0,4,0,0,0,0
"8632","10544978",0,4,6,0,0,6
"8633","10545036",0,1,0,0,0,0
"8634","10545037",0,5,0,0,0,0
"8635","10545056",0,2,0,0,0,0
"8636","10545144",0,2,1,1,0,2
"8637","10545156",0,1,0,0,0,0
"8638","10545170",0,8,5,10,1,16
"8639","10545197",0,2,0,0,0,0
"8640","10545205",0,5,0,4,0,4
"8641","10545229",0,5,2,3,0,5
"8642","10545232",0,4,4,2,0,6
"8643","10545255",0,5,3,0,0,3
"8644","10545307",0,3,1,0,0,1
"8645","10545323",0,3,0,1,0,1
"8646","10545342",0,3,2,0,0,2
"8647","10545354",0,2,2,0,0,2
"8648","10545363",0,7,4,8,2,14
"8649","10545370",0,5,3,2,0,5
"8650","10545372",0,4,0,0,0,0
"8651","10545373",0,3,2,0,0,2
"8652","10545375",0,4,9,1,0,10
"8653","10545423",0,5,0,0,0,0
"8654","10545432",0,3,0,0,0,0
"8655","10545441",0,3,2,1,0,3
"8656","10545442",0,5,6,3,0,9
"8657","10545449",0,2,0,0,0,0
"8658","10545450",0,5,5,4,0,9
"8659","10545456",0,4,0,0,0,0
"8660","10545463",0,4,1,1,0,2
"8661","10545519",1,5,0,1,0,1
"8662","10545529",0,3,3,0,0,3
"8663","10545532",0,4,0,0,0,0
"8664","10545535",0,4,6,1,0,7
"8665","10545551",0,4,6,3,0,9
"8666","10545570",0,5,0,1,1,2
"8667","10545592",0,4,1,1,0,2
"8668","10545619",0,6,4,5,0,9
"8669","10545621",0,3,0,0,0,0
"8670","10545624",0,6,8,2,0,10
"8671","10545628",0,3,1,0,0,1
"8672","10545636",0,1,0,0,0,0
"8673","10545637",0,2,0,1,0,1
"8674","10545638",0,4,0,0,0,0
"8675","10545681",0,3,5,2,0,7
"8676","10545687",0,6,6,2,0,8
"8677","10545688",0,5,9,1,0,10
"8678","10545706",0,6,6,1,0,7
"8679","10545749",0,5,4,3,0,7
"8680","10545762",0,4,7,1,0,8
"8681","10545794",0,2,1,1,0,2
"8682","10545822",0,1,0,0,0,0
"8683","10545894",0,4,0,2,0,2
"8684","10545941",0,7,6,5,1,12
"8685","10545947",0,3,0,0,0,0
"8686","10545956",0,3,0,0,0,0
"8687","10545961",0,7,4,6,2,12
"8688","10545974",0,2,0,1,0,1
"8689","10545978",0,5,6,2,0,8
"8690","10545990",0,8,7,8,3,18
"8691","10546012",0,5,7,5,1,13
"8692","10546064",0,2,0,0,0,0
"8693","10546086",0,5,3,3,0,6
"8694","10546116",0,5,7,5,1,13
"8695","10546118",0,4,0,0,0,0
"8696","10546181",0,5,2,1,0,3
"8697","10546215",0,3,0,0,0,0
"8698","10546220",0,2,4,0,0,4
"8699","10546266",0,4,2,4,0,6
"8700","10546270",0,6,2,1,0,3
"8701","10546273",0,3,1,0,0,1
"8702","10546276",0,4,2,0,0,2
"8703","10546279",0,3,0,0,0,0
"8704","10546285",0,5,1,2,0,3
"8705","10546306",0,4,1,0,0,1
"8706","10546315",0,5,2,0,0,2
"8707","10546333",0,6,2,1,0,3
"8708","10546348",0,4,0,0,0,0
"8709","10546352",0,3,2,1,0,3
"8710","10546355",0,4,2,2,0,4
"8711","10546416",0,3,0,0,0,0
"8712","10546432",0,5,6,4,0,10
"8713","10546435",0,3,0,0,0,0
"8714","10546440",0,2,0,0,0,0
"8715","10546446",0,4,7,3,0,10
"8716","10546454",0,5,0,1,0,1
"8717","10546483",0,3,1,2,0,3
"8718","10546500",0,3,0,2,0,2
"8719","10546518",0,3,1,0,0,1
"8720","10546567",0,2,0,3,0,3
"8721","10546569",0,5,4,2,0,6
"8722","10546580",0,4,1,0,0,1
"8723","10546589",0,7,3,4,0,7
"8724","10546592",0,4,2,3,0,5
"8725","10546621",0,4,3,1,0,4
"8726","10546624",0,5,2,0,0,2
"8727","10546643",0,3,0,1,0,1
"8728","10546699",0,10,7,13,4,24
"8729","10546706",0,2,0,0,0,0
"8730","10546720",0,2,0,0,0,0
"8731","10546740",0,3,0,1,0,1
"8732","10546744",0,6,1,1,1,3
"8733","10546762",1,5,1,7,0,8
"8734","10546766",0,5,5,3,0,8
"8735","10546776",0,5,8,6,0,14
"8736","10546878",0,3,3,1,0,4
"8737","10546909",0,4,0,0,0,0
"8738","10547034",0,4,1,1,0,2
"8739","10547037",0,2,0,0,0,0
"8740","10547054",0,4,3,0,0,3
"8741","10547082",1,5,2,0,0,2
"8742","10547206",0,6,2,6,1,9
"8743","10547208",0,4,0,0,0,0
"8744","10547245",0,6,4,3,0,7
"8745","10547284",0,7,3,3,0,6
"8746","10547313",0,6,8,9,2,19
"8747","10547321",0,4,0,1,0,1
"8748","10547326",0,2,2,1,0,3
"8749","10547330",0,7,5,9,2,16
"8750","10547349",0,2,0,0,0,0
"8751","10547354",0,2,0,0,0,0
"8752","10547434",0,7,6,7,1,14
"8753","10547450",0,4,2,0,0,2
"8754","10547455",0,5,9,5,0,14
"8755","10547477",0,2,2,1,0,3
"8756","10547504",0,3,0,0,0,0
"8757","10547513",0,4,0,0,0,0
"8758","10547533",0,3,1,1,0,2
"8759","10547571",0,3,3,2,0,5
"8760","10547592",0,4,2,0,0,2
"8761","10547622",0,4,0,1,0,1
"8762","10547634",0,4,0,2,0,2
"8763","10547707",0,4,0,0,0,0
"8764","10547713",0,5,1,2,0,3
"8765","10547724",0,2,0,2,1,3
"8766","10547735",0,4,5,3,0,8
"8767","10547749",0,2,2,1,0,3
"8768","10547755",0,2,0,0,0,0
"8769","10547802",0,7,9,8,0,17
"8770","10547812",0,4,7,5,0,12
"8771","10547822",0,1,0,0,0,0
"8772","10547855",0,2,0,0,0,0
"8773","10547862",0,4,1,1,0,2
"8774","10547874",0,5,5,1,0,6
"8775","10547903",0,5,1,2,1,4
"8776","10547922",0,8,5,7,2,14
"8777","10547924",0,4,0,1,0,1
"8778","10547931",0,4,2,1,0,3
"8779","10547942",0,4,1,0,0,1
"8780","10547943",0,2,0,0,0,0
"8781","10547965",0,5,7,5,0,12
"8782","10547970",0,6,5,4,0,9
"8783","10547992",0,4,0,0,0,0
"8784","10547998",0,4,4,0,0,4
"8785","10547999",0,2,0,0,0,0
"8786","10548005",0,3,0,0,0,0
"8787","10548058",0,1,0,0,0,0
"8788","10548059",0,6,3,2,0,5
"8789","10548084",1,4,0,1,0,1
"8790","10548150",0,5,2,3,0,5
"8791","10548155",0,5,2,0,0,2
"8792","10548164",0,6,3,5,0,8
"8793","10548204",0,4,0,0,0,0
"8794","10548206",0,3,2,2,0,4
"8795","10548208",0,3,0,3,0,3
"8796","10548210",0,3,0,0,0,0
"8797","10548216",0,3,2,3,0,5
"8798","10548252",0,2,0,0,0,0
"8799","10548255",0,5,7,0,0,7
"8800","10548271",0,5,2,4,1,7
"8801","10548289",0,3,0,0,0,0
"8802","10548313",0,3,0,0,0,0
"8803","10548325",0,5,0,0,0,0
"8804","10548355",0,2,1,2,0,3
"8805","10548359",0,4,3,0,0,3
"8806","10548360",0,4,0,0,0,0
"8807","10548364",0,3,1,0,0,1
"8808","10548374",0,4,0,0,0,0
"8809","10548386",0,1,0,0,0,0
"8810","10548414",0,2,0,0,0,0
"8811","10548420",0,3,3,0,0,3
"8812","10548421",0,2,2,0,0,2
"8813","10548427",0,5,7,3,0,10
"8814","10548428",0,4,0,0,0,0
"8815","10548435",0,6,2,0,0,2
"8816","10548454",0,4,1,2,0,3
"8817","10548471",0,4,2,1,0,3
"8818","10548477",0,6,2,3,0,5
"8819","10548483",0,4,1,0,0,1
"8820","10548513",0,4,0,1,0,1
"8821","10548551",0,1,0,0,0,0
"8822","10548579",0,5,2,3,0,5
"8823","10548597",0,4,4,3,0,7
"8824","10548598",0,3,0,0,0,0
"8825","10548599",1,4,1,3,0,4
"8826","10548604",0,5,0,0,0,0
"8827","10548605",0,5,1,0,0,1
"8828","10548607",0,4,0,1,0,1
"8829","10548608",1,4,1,1,0,2
"8830","10548612",1,4,3,4,0,7
"8831","10548622",0,3,1,0,0,1
"8832","10548653",0,5,7,6,3,16
"8833","10548680",0,3,0,2,0,2
"8834","10548728",0,2,0,0,0,0
"8835","10548747",0,9,6,17,2,25
"8836","10548757",0,6,8,6,0,14
"8837","10548760",0,6,4,7,0,11
"8838","10548761",0,5,3,1,0,4
"8839","10548798",0,5,4,4,0,8
"8840","10548830",0,6,3,2,0,5
"8841","10548889",0,4,2,1,0,3
"8842","10548907",0,1,0,0,0,0
"8843","10548911",0,5,0,1,0,1
"8844","10548930",0,5,0,1,0,1
"8845","10548956",0,2,0,0,0,0
"8846","10548973",0,7,1,1,0,2
"8847","10548975",0,6,3,5,0,8
"8848","10548981",0,8,13,1,1,15
"8849","10548989",0,4,2,1,0,3
"8850","10549035",0,3,0,0,0,0
"8851","10549046",0,4,3,1,0,4
"8852","10549061",0,2,0,0,0,0
"8853","10549073",0,2,0,0,0,0
"8854","10549076",0,2,1,1,0,2
"8855","10549090",0,4,0,1,0,1
"8856","10549101",0,3,0,0,0,0
"8857","10549104",0,3,0,0,0,0
"8858","10549105",0,6,7,10,0,17
"8859","10549117",0,5,2,5,0,7
"8860","10549124",0,5,2,7,0,9
"8861","10549125",0,3,1,0,0,1
"8862","10549131",0,2,1,0,0,1
"8863","10549169",0,2,0,0,0,0
"8864","10549173",0,5,2,4,0,6
"8865","10549177",0,3,0,0,0,0
"8866","10549234",0,5,2,2,0,4
"8867","10549265",0,4,2,3,0,5
"8868","10549268",0,4,0,0,0,0
"8869","10549271",0,3,1,0,0,1
"8870","10549273",0,4,3,0,0,3
"8871","10549289",0,4,3,5,0,8
"8872","10549303",0,4,0,0,0,0
"8873","10549326",0,2,0,0,0,0
"8874","10549332",0,4,2,0,0,2
"8875","10549339",0,3,3,1,0,4
"8876","10549386",0,6,7,6,0,13
"8877","10549393",0,4,3,1,0,4
"8878","10549398",0,4,4,2,0,6
"8879","10549404",0,7,1,4,0,5
"8880","10549443",0,4,2,1,0,3
"8881","10549454",0,3,0,0,0,0
"8882","10549458",0,4,2,4,0,6
"8883","10549468",0,1,0,0,0,0
"8884","10549515",0,6,6,2,0,8
"8885","10549517",0,5,5,0,0,5
"8886","10549521",0,4,2,0,0,2
"8887","10549550",0,3,1,2,0,3
"8888","10549577",0,6,12,3,1,16
"8889","10549584",0,1,0,0,0,0
"8890","10549597",0,6,5,7,1,13
"8891","10549602",1,4,0,0,0,0
"8892","10549611",0,3,1,1,0,2
"8893","10549622",0,4,5,2,0,7
"8894","10549644",0,4,1,1,0,2
"8895","10549663",0,5,1,5,1,7
"8896","10549664",0,4,0,2,0,2
"8897","10549682",0,5,1,2,0,3
"8898","10549687",0,4,0,0,0,0
"8899","10549688",0,4,0,0,0,0
"8900","10549691",0,6,7,6,0,13
"8901","10549700",0,6,0,2,1,3
"8902","10549708",0,5,0,0,0,0
"8903","10549730",1,4,1,1,0,2
"8904","10549736",0,4,1,0,0,1
"8905","10549737",0,5,0,0,0,0
"8906","10549746",0,3,0,0,0,0
"8907","10549762",0,4,1,0,0,1
"8908","10549796",0,7,8,8,2,18
"8909","10549844",0,4,6,4,0,10
"8910","10549848",0,3,0,0,0,0
"8911","10549864",0,4,3,1,0,4
"8912","10549871",0,7,5,4,0,9
"8913","10549877",0,4,6,1,0,7
"8914","10549906",0,4,6,3,0,9
"8915","10549910",0,4,0,0,0,0
"8916","10549911",0,4,2,0,0,2
"8917","10549917",0,1,0,0,0,0
"8918","10549935",0,5,4,4,2,10
"8919","10549953",0,2,2,1,0,3
"8920","10549955",0,4,0,0,0,0
"8921","10549956",0,3,3,1,0,4
"8922","10549958",0,3,3,4,0,7
"8923","10549962",0,2,0,0,0,0
"8924","10549974",0,4,2,2,0,4
"8925","10549987",0,5,2,2,0,4
"8926","10550006",0,4,4,1,0,5
"8927","10550026",0,3,0,0,0,0
"8928","10550037",0,6,1,2,0,3
"8929","10550047",0,5,2,1,0,3
"8930","10550069",0,2,0,0,0,0
"8931","10550070",0,4,0,1,0,1
"8932","10550071",0,6,5,2,0,7
"8933","10550074",0,1,0,0,0,0
"8934","10550081",0,6,3,1,0,4
"8935","10550093",0,2,1,2,0,3
"8936","10550095",0,8,16,6,0,22
"8937","10550097",0,1,0,0,0,0
"8938","10550126",0,2,4,5,0,9
"8939","10550130",0,4,0,3,0,3
"8940","10550136",0,4,6,6,0,12
"8941","10550137",0,2,0,0,0,0
"8942","10550144",0,4,0,2,0,2
"8943","10550151",0,4,0,0,0,0
"8944","10550159",0,5,1,6,0,7
"8945","10550169",1,5,0,6,0,6
"8946","10550181",0,4,5,1,0,6
"8947","10550187",0,2,0,1,0,1
"8948","10550189",0,4,1,0,0,1
"8949","10550196",0,4,3,3,0,6
"8950","10550214",0,1,0,0,0,0
"8951","10550230",0,5,2,0,0,2
"8952","10550250",0,2,0,0,0,0
"8953","10550258",0,8,13,14,1,28
"8954","10550263",0,2,0,0,0,0
"8955","10550272",0,4,3,0,0,3
"8956","10550277",0,3,3,2,0,5
"8957","10550289",0,3,0,2,0,2
"8958","10550320",0,5,4,3,2,9
"8959","10550328",0,6,5,7,3,15
"8960","10550334",0,2,1,0,0,1
"8961","10550338",0,6,9,2,0,11
"8962","10550357",0,5,0,3,0,3
"8963","10550359",0,3,2,0,0,2
"8964","10550381",0,4,3,1,0,4
"8965","10550383",0,4,2,4,0,6
"8966","10550386",0,4,3,7,0,10
"8967","10550388",0,4,1,0,0,1
"8968","10550393",0,4,3,0,1,4
"8969","10550410",0,2,2,1,0,3
"8970","10550417",0,2,0,0,0,0
"8971","10550436",0,1,0,0,0,0
"8972","10550504",0,1,0,0,0,0
"8973","10550509",0,2,2,1,0,3
"8974","10550519",0,2,0,0,0,0
"8975","10550530",0,1,0,0,0,0
"8976","10550536",0,7,14,5,0,19
"8977","10550539",0,6,8,9,2,19
"8978","10550547",0,3,3,0,0,3
"8979","10550555",0,4,0,0,0,0
"8980","10550565",0,3,1,0,0,1
"8981","10550576",0,5,5,17,1,23
"8982","10550606",0,4,4,1,0,5
"8983","10550618",0,4,5,5,0,10
"8984","10550625",0,4,7,3,0,10
"8985","10550626",0,5,1,3,0,4
"8986","10550628",0,4,0,1,0,1
"8987","10550631",0,4,0,2,0,2
"8988","10550644",0,6,0,0,0,0
"8989","10550645",0,2,0,0,0,0
"8990","10550652",0,7,0,2,0,2
"8991","10550664",0,2,0,0,0,0
"8992","10550677",0,2,0,0,0,0
"8993","10550693",0,5,0,0,0,0
"8994","10550697",0,3,0,0,0,0
"8995","10550698",0,2,0,0,0,0
"8996","10550703",0,4,1,1,0,2
"8997","10550708",0,4,0,4,0,4
"8998","10550713",0,3,3,0,0,3
"8999","10550768",0,3,2,1,0,3
"9000","10550852",0,5,0,3,0,3
"9001","10550877",0,5,0,0,0,0
"9002","10550883",0,5,2,7,2,11
"9003","10550915",0,4,4,7,0,11
"9004","10550920",0,6,7,4,1,12
"9005","10550921",0,2,3,0,0,3
"9006","10550922",0,3,0,1,0,1
"9007","10550928",0,5,7,9,0,16
"9008","10550939",0,4,0,0,0,0
"9009","10550966",0,4,0,0,0,0
"9010","10550980",0,4,11,5,2,18
"9011","10551001",0,1,1,0,0,1
"9012","10551003",0,5,0,0,0,0
"9013","10551004",0,2,0,0,0,0
"9014","10551019",0,5,1,2,0,3
"9015","10551072",0,4,0,0,0,0
"9016","10551108",0,4,1,0,0,1
"9017","10551192",0,1,0,0,0,0
"9018","10551200",0,3,0,0,0,0
"9019","10551201",0,1,1,0,0,1
"9020","10551244",0,4,1,1,0,2
"9021","10551288",0,7,6,7,1,14
"9022","10551294",0,4,0,1,0,1
"9023","10551359",0,7,7,8,2,17
"9024","10551385",0,5,0,2,0,2
"9025","10551389",0,4,5,3,0,8
"9026","10551395",0,3,5,1,0,6
"9027","10551402",0,6,0,3,0,3
"9028","10551409",0,5,1,5,0,6
"9029","10551410",0,3,0,0,0,0
"9030","10551421",0,3,0,2,0,2
"9031","10551436",0,2,0,0,0,0
"9032","10551447",0,4,0,0,0,0
"9033","10551467",0,4,1,0,0,1
"9034","10551471",0,3,0,0,0,0
"9035","10551495",0,7,7,10,2,19
"9036","10551496",0,3,0,0,0,0
"9037","10551550",0,6,3,7,2,12
"9038","10551602",0,3,0,0,0,0
"9039","10551603",0,5,1,0,0,1
"9040","10551622",0,5,3,5,1,9
"9041","10551674",0,1,0,0,0,0
"9042","10551675",0,6,6,6,1,13
"9043","10551689",0,4,5,2,0,7
"9044","10551700",0,4,4,1,0,5
"9045","10551741",0,6,9,3,0,12
"9046","10551744",0,1,0,0,0,0
"9047","10551750",0,2,0,1,0,1
"9048","10551770",0,2,0,1,0,1
"9049","10551836",0,3,0,0,0,0
"9050","10551837",0,3,0,3,0,3
"9051","10551895",0,3,0,0,0,0
"9052","10551923",0,3,0,0,0,0
"9053","10551926",0,4,2,1,0,3
"9054","10551964",0,4,1,8,0,9
"9055","10552002",0,5,7,6,0,13
"9056","10552050",0,3,1,0,0,1
"9057","10552051",0,7,6,6,0,12
"9058","10552129",0,4,1,0,0,1
"9059","10552186",0,1,0,0,0,0
"9060","10552205",0,4,2,1,0,3
"9061","10552223",0,3,0,0,0,0
"9062","10552237",0,3,0,0,0,0
"9063","10552323",0,1,0,0,0,0
"9064","10552339",0,3,3,4,0,7
"9065","10552380",0,4,6,6,2,14
"9066","10552411",0,2,0,0,0,0
"9067","10552412",0,2,6,1,0,7
"9068","10552421",0,2,0,0,0,0
"9069","10552435",0,6,1,3,0,4
"9070","10552442",0,3,0,1,0,1
"9071","10552455",0,5,5,1,0,6
"9072","10552461",0,3,0,0,0,0
"9073","10552462",0,3,0,4,0,4
"9074","10552466",0,3,2,2,0,4
"9075","10552470",0,3,1,1,0,2
"9076","10552507",0,7,3,11,0,14
"9077","10552541",0,1,0,0,0,0
"9078","10552565",0,3,4,0,0,4
"9079","10552578",0,7,4,7,4,15
"9080","10552587",0,4,2,3,0,5
"9081","10552629",0,8,3,10,5,18
"9082","10552674",0,3,0,0,0,0
"9083","10552692",0,1,0,0,0,0
"9084","10552696",0,3,0,0,0,0
"9085","10552709",0,4,4,6,0,10
"9086","10552714",0,3,0,0,0,0
"9087","10552716",0,3,0,0,0,0
"9088","10552719",0,2,0,0,0,0
"9089","10552839",0,3,0,0,0,0
"9090","10552843",0,4,3,3,0,6
"9091","10552847",0,4,0,1,0,1
"9092","10552856",0,2,0,0,0,0
"9093","10552864",0,5,6,2,0,8
"9094","10552877",0,3,3,0,0,3
"9095","10552887",0,1,0,0,0,0
"9096","10552906",0,3,0,3,0,3
"9097","10552910",0,2,1,1,0,2
"9098","10552956",0,6,8,8,1,17
"9099","10552970",0,3,0,2,0,2
"9100","10552994",0,1,0,0,0,0
"9101","10552995",0,3,3,1,0,4
"9102","10553049",0,3,0,2,0,2
"9103","10553100",0,3,1,0,0,1
"9104","10553190",0,2,1,0,0,1
"9105","10553194",0,5,2,4,1,7
"9106","10553213",0,4,5,3,0,8
"9107","10553215",0,2,3,0,0,3
"9108","10553245",0,2,0,0,0,0
"9109","10553317",0,5,1,5,0,6
"9110","10553351",0,2,0,2,0,2
"9111","10553377",0,3,0,0,0,0
"9112","10553397",0,3,0,0,0,0
"9113","10553404",0,3,1,1,0,2
"9114","10553416",0,5,1,3,0,4
"9115","10553433",0,2,1,0,0,1
"9116","10553454",0,3,2,2,2,6
"9117","10553456",0,3,0,0,0,0
"9118","10553458",0,4,5,2,1,8
"9119","10553462",0,4,6,0,0,6
"9120","10553478",0,4,1,1,0,2
"9121","10553505",0,2,1,1,0,2
"9122","10553551",0,8,17,10,1,28
"9123","10553702",0,6,9,2,0,11
"9124","10553801",0,3,0,0,0,0
"9125","10553843",0,2,0,0,0,0
"9126","10553868",0,5,3,5,0,8
"9127","10553891",0,3,2,0,0,2
"9128","10553921",0,6,6,1,0,7
"9129","10553922",0,3,1,0,0,1
"9130","10553928",0,6,1,1,0,2
"9131","10553944",0,2,1,0,0,1
"9132","10553965",0,4,0,0,0,0
"9133","10553979",0,4,4,3,0,7
"9134","10553981",0,3,0,0,0,0
"9135","10553982",0,1,0,0,0,0
"9136","10553983",0,3,0,0,0,0
"9137","10553995",0,3,0,1,0,1
"9138","10554003",0,4,0,1,0,1
"9139","10554006",0,1,0,0,0,0
"9140","10554013",0,3,0,0,0,0
"9141","10554014",0,1,0,0,0,0
"9142","10554017",0,1,0,0,0,0
"9143","10554019",0,4,2,1,0,3
"9144","10554021",0,4,1,0,0,1
"9145","10554029",0,1,0,0,0,0
"9146","10554045",0,2,0,1,0,1
"9147","10554097",0,2,0,0,0,0
"9148","10554103",0,7,5,6,0,11
"9149","10554107",0,4,1,2,0,3
"9150","10554118",0,4,4,3,0,7
"9151","10554124",0,4,1,0,0,1
"9152","10554208",0,4,0,1,0,1
"9153","10554212",0,4,6,2,0,8
"9154","10554322",0,2,0,0,0,0
"9155","10554331",0,2,0,0,0,0
"9156","10554347",0,5,4,0,0,4
"9157","10554349",0,4,2,0,0,2
"9158","10554354",0,3,0,0,0,0
"9159","10554356",0,7,1,3,0,4
"9160","10554369",0,3,5,2,0,7
"9161","10554377",0,4,7,1,0,8
"9162","10554390",0,2,1,3,0,4
"9163","10554420",0,4,0,1,0,1
"9164","10554435",0,7,4,6,0,10
"9165","10554441",0,3,0,0,0,0
"9166","10554443",0,3,0,0,0,0
"9167","10554445",0,1,0,0,0,0
"9168","10554446",0,3,0,4,0,4
"9169","10554447",0,4,0,0,0,0
"9170","10554457",0,4,10,2,0,12
"9171","10554458",0,4,0,1,0,1
"9172","10554463",0,3,1,1,0,2
"9173","10554467",0,3,0,0,0,0
"9174","10554468",0,1,0,0,0,0
"9175","10554469",0,2,0,0,0,0
"9176","10554484",0,3,1,0,0,1
"9177","10554492",0,3,0,0,0,0
"9178","10554495",0,5,1,1,0,2
"9179","10554502",0,2,1,3,1,5
"9180","10554503",0,1,0,0,0,0
"9181","10554507",0,4,1,1,0,2
"9182","10554520",0,1,0,0,0,0
"9183","10554525",0,3,0,0,0,0
"9184","10554532",0,1,1,0,0,1
"9185","10554540",0,3,1,3,0,4
"9186","10554561",0,2,0,0,0,0
"9187","10554595",0,3,1,2,1,4
"9188","10554602",0,4,0,0,0,0
"9189","10554606",0,8,8,12,1,21
"9190","10554609",0,3,0,0,0,0
"9191","10554621",0,5,2,5,0,7
"9192","10554630",0,5,9,3,0,12
"9193","10554703",0,4,1,2,0,3
"9194","10554794",0,4,0,0,0,0
"9195","10554799",0,4,2,4,0,6
"9196","10554809",0,5,0,1,0,1
"9197","10554822",0,5,0,0,0,0
"9198","10554838",0,2,1,3,0,4
"9199","10554840",0,3,2,0,0,2
"9200","10554883",0,3,1,4,0,5
"9201","10554891",0,4,1,3,0,4
"9202","10554892",0,4,0,0,0,0
"9203","10554919",0,3,0,0,0,0
"9204","10554960",0,3,2,0,0,2
"9205","10554968",0,4,8,4,0,12
"9206","10554971",0,4,3,4,0,7
"9207","10554976",0,4,0,0,0,0
"9208","10554978",0,3,1,6,0,7
"9209","10555009",0,5,0,0,0,0
"9210","10555065",0,5,6,4,0,10
"9211","10555067",1,3,0,0,0,0
"9212","10555068",0,5,2,0,0,2
"9213","10555088",0,4,2,5,0,7
"9214","10555102",0,2,0,0,0,0
"9215","10555103",0,3,0,2,0,2
"9216","10555104",0,3,1,0,0,1
"9217","10555108",0,1,0,0,0,0
"9218","10555110",0,3,0,1,0,1
"9219","10555120",0,5,12,2,0,14
"9220","10555144",0,2,3,3,0,6
"9221","10555170",0,4,0,0,0,0
"9222","10555177",0,4,3,3,0,6
"9223","10555180",0,2,0,0,0,0
"9224","10555202",0,3,3,2,0,5
"9225","10555223",0,4,2,2,0,4
"9226","10555227",0,5,1,5,1,7
"9227","10555254",0,2,0,0,0,0
"9228","10555262",0,1,0,0,0,0
"9229","10555335",0,2,1,2,1,4
"9230","10555351",0,1,0,0,0,0
"9231","10555368",0,3,0,0,0,0
"9232","10555424",0,3,2,4,0,6
"9233","10555456",0,4,0,1,0,1
"9234","10555549",0,2,0,0,0,0
"9235","10555554",0,1,0,0,0,0
"9236","10555588",0,2,1,0,0,1
"9237","10555596",0,3,0,0,0,0
"9238","10555603",0,3,0,1,0,1
"9239","10555604",0,3,0,1,0,1
"9240","10555608",0,3,1,0,0,1
"9241","10555610",0,3,0,0,0,0
"9242","10555629",0,3,2,1,0,3
"9243","10555695",0,3,2,0,0,2
"9244","10555731",0,3,0,0,0,0
"9245","10555735",0,3,0,3,0,3
"9246","10555737",0,2,1,0,0,1
"9247","10555746",0,3,4,3,0,7
"9248","10555761",0,3,1,3,0,4
"9249","10555770",0,3,3,2,0,5
"9250","10555775",0,3,0,0,0,0
"9251","10555787",0,2,1,0,0,1
"9252","10555818",0,4,4,1,0,5
"9253","10555819",0,4,4,3,0,7
"9254","10555820",0,3,0,3,0,3
"9255","10555821",0,5,0,0,0,0
"9256","10555822",0,3,0,0,0,0
"9257","10555877",0,2,0,2,0,2
"9258","10555885",0,1,0,1,0,1
"9259","10555898",0,2,0,2,0,2
"9260","10555925",0,1,0,2,0,2
"9261","10555948",0,3,8,0,0,8
"9262","10555953",0,3,0,0,0,0
"9263","10555954",0,2,1,5,0,6
"9264","10555957",0,3,3,2,0,5
"9265","10555965",0,3,5,3,2,10
"9266","10555986",0,4,1,5,0,6
"9267","10556023",0,4,2,1,0,3
"9268","10556024",0,2,0,0,0,0
"9269","10556025",0,4,1,1,0,2
"9270","10556040",0,3,2,1,0,3
"9271","10556056",0,4,0,2,0,2
"9272","10556073",0,2,0,1,0,1
"9273","10556092",0,4,4,0,0,4
"9274","10556103",0,3,0,0,0,0
"9275","10556113",0,6,2,3,1,6
"9276","10556130",0,5,1,4,0,5
"9277","10556137",1,3,0,0,0,0
"9278","10556182",0,2,1,0,0,1
"9279","10556183",0,3,1,1,0,2
"9280","10556201",0,3,2,3,0,5
"9281","10556211",0,3,0,0,0,0
"9282","10556226",0,3,4,1,0,5
"9283","10556228",0,4,1,6,0,7
"9284","10556231",0,6,2,1,0,3
"9285","10556232",0,3,3,0,0,3
"9286","10556234",0,2,0,0,0,0
"9287","10556242",0,2,0,1,0,1
"9288","10556253",0,4,2,1,0,3
"9289","10556266",0,2,1,0,0,1
"9290","10556276",0,2,1,1,0,2
"9291","10556339",0,1,0,0,0,0
"9292","10556475",0,6,7,4,1,12
"9293","10556477",0,5,6,6,0,12
"9294","10556478",0,3,1,0,0,1
"9295","10556480",0,2,0,0,0,0
"9296","10556482",0,4,1,1,0,2
"9297","10556542",0,3,0,0,0,0
"9298","10556594",0,5,6,3,0,9
"9299","10556602",0,3,2,1,0,3
"9300","10556607",0,4,2,1,0,3
"9301","10556612",0,4,5,2,0,7
"9302","10556619",0,3,0,0,0,0
"9303","10556624",0,2,0,0,0,0
"9304","10556640",0,4,4,1,0,5
"9305","10556642",0,6,1,8,0,9
"9306","10556670",0,4,0,0,0,0
"9307","10556690",0,4,4,0,0,4
"9308","10556693",0,1,0,0,0,0
"9309","10556703",0,4,3,3,0,6
"9310","10556735",0,5,5,2,0,7
"9311","10556747",0,4,0,0,0,0
"9312","10556769",0,3,1,0,0,1
"9313","10556771",0,3,1,0,0,1
"9314","10556785",0,3,1,0,0,1
"9315","10556812",0,4,2,1,0,3
"9316","10556821",0,3,1,0,0,1
"9317","10556822",0,3,4,0,0,4
"9318","10556880",0,1,0,0,0,0
"9319","10556921",0,2,0,0,0,0
"9320","10556959",0,5,3,2,0,5
"9321","10556964",0,4,2,2,1,5
"9322","10556998",0,5,10,1,0,11
"9323","10556999",0,4,7,6,0,13
"9324","10557002",1,6,1,1,0,2
"9325","10557019",0,1,0,0,0,0
"9326","10557031",0,4,2,1,0,3
"9327","10557061",0,4,1,1,0,2
"9328","10557068",0,4,0,0,0,0
"9329","10557085",0,4,0,0,0,0
"9330","10557086",1,4,0,0,0,0
"9331","10557113",0,3,0,0,0,0
"9332","10557121",0,4,1,3,0,4
"9333","10557122",0,1,0,0,0,0
"9334","10557123",0,4,2,2,0,4
"9335","10557158",0,4,0,2,0,2
"9336","10557161",0,8,11,11,4,26
"9337","10557208",0,4,0,0,0,0
"9338","10557226",0,5,2,4,1,7
"9339","10557235",0,2,0,0,0,0
"9340","10557236",0,4,3,1,0,4
"9341","10557237",0,4,0,1,0,1
"9342","10557251",0,1,0,0,0,0
"9343","10557259",0,4,0,0,0,0
"9344","10557262",1,4,1,2,0,3
"9345","10557268",0,1,0,0,0,0
"9346","10557286",0,4,2,9,0,11
"9347","10557322",0,3,1,0,0,1
"9348","10557357",0,3,1,0,0,1
"9349","10557387",0,3,7,1,0,8
"9350","10557422",0,4,1,3,0,4
"9351","10557427",0,5,6,4,0,10
"9352","10557458",0,2,0,0,0,0
"9353","10557459",0,2,0,1,0,1
"9354","10557467",0,1,0,0,0,0
"9355","10557470",0,4,0,1,0,1
"9356","10557478",0,3,0,0,0,0
"9357","10557487",0,3,3,4,0,7
"9358","10557488",0,1,0,1,0,1
"9359","10557492",0,3,1,0,0,1
"9360","10557582",0,3,0,1,0,1
"9361","10557594",0,4,2,7,0,9
"9362","10557600",0,5,8,4,1,13
"9363","10557625",0,3,0,1,0,1
"9364","10557627",0,4,0,0,0,0
"9365","10557654",0,1,0,0,0,0
"9366","10557669",0,2,6,1,0,7
"9367","10557677",0,2,0,1,0,1
"9368","10557681",0,3,0,0,0,0
"9369","10557683",0,7,9,12,0,21
"9370","10557695",0,3,1,0,0,1
"9371","10557717",0,1,0,0,0,0
"9372","10557729",0,2,1,1,1,3
"9373","10557730",0,3,0,1,0,1
"9374","10557788",0,3,0,2,0,2
"9375","10557801",0,5,8,3,0,11
"9376","10557821",0,3,0,2,0,2
"9377","10557829",0,6,4,5,0,9
"9378","10557866",0,2,0,0,0,0
"9379","10557931",0,2,0,0,0,0
"9380","10557934",0,3,1,2,0,3
"9381","10557937",0,2,0,0,0,0
"9382","10557984",0,1,0,0,0,0
"9383","10558021",0,3,0,0,0,0
"9384","10558024",0,3,0,1,0,1
"9385","10558040",0,6,6,7,3,16
"9386","10558208",0,3,1,0,0,1
"9387","10558273",0,2,0,0,0,0
"9388","10558275",0,3,0,0,0,0
"9389","10558278",0,6,5,4,0,9
"9390","10558310",0,5,1,2,0,3
"9391","10558311",1,4,0,0,0,0
"9392","10558312",0,4,2,5,0,7
"9393","10558318",0,3,1,1,0,2
"9394","10558323",0,4,0,0,0,0
"9395","10558369",0,3,4,2,0,6
"9396","10558452",0,3,0,1,0,1
"9397","10558585",0,3,0,0,0,0
"9398","10558606",0,4,0,0,0,0
"9399","10558636",0,2,6,2,0,8
"9400","10558704",0,3,0,6,0,6
"9401","10558730",0,5,2,4,1,7
"9402","10558772",0,4,1,3,1,5
"9403","10558785",0,6,9,8,0,17
"9404","10558810",0,2,0,0,0,0
"9405","10558838",0,4,3,0,0,3
"9406","10558840",0,3,0,0,0,0
"9407","10558847",0,4,6,1,0,7
"9408","10558853",0,2,1,2,1,4
"9409","10558855",0,3,3,1,0,4
"9410","10558858",0,4,0,0,0,0
"9411","10558885",0,5,0,0,0,0
"9412","10558906",0,1,0,0,0,0
"9413","10558955",0,4,0,3,0,3
"9414","10558960",0,3,0,0,0,0
"9415","10558982",0,2,0,0,0,0
"9416","10558983",0,4,1,3,0,4
"9417","10558988",0,4,0,3,0,3
"9418","10558989",0,4,1,0,0,1
"9419","10559000",0,4,3,4,2,9
"9420","10559002",0,4,9,5,0,14
"9421","10559007",0,4,0,0,0,0
"9422","10559021",0,3,4,2,0,6
"9423","10559023",0,3,1,0,0,1
"9424","10559062",0,5,0,2,0,2
"9425","10559066",0,4,3,6,1,10
"9426","10559088",0,3,0,1,0,1
"9427","10559098",0,2,0,0,0,0
"9428","10559102",0,5,0,0,0,0
"9429","10559103",0,3,1,6,0,7
"9430","10559216",0,4,0,0,0,0
"9431","10559262",0,4,4,1,0,5
"9432","10559316",0,5,5,6,0,11
"9433","10559326",0,1,0,1,0,1
"9434","10559339",0,3,0,0,0,0
"9435","10559371",0,4,8,5,0,13
"9436","10559380",0,4,3,2,0,5
"9437","10559382",0,4,0,3,0,3
"9438","10559383",0,2,5,0,0,5
"9439","10559416",1,3,0,0,0,0
"9440","10559424",0,3,3,1,0,4
"9441","10559430",0,4,3,4,0,7
"9442","10559451",0,6,2,8,0,10
"9443","10559460",0,4,0,1,0,1
"9444","10559492",0,3,2,0,0,2
"9445","10559495",0,3,0,1,0,1
"9446","10559499",0,4,4,4,0,8
"9447","10559500",0,3,1,1,0,2
"9448","10559507",0,2,0,0,0,0
"9449","10559550",0,1,0,0,0,0
"9450","10559601",0,6,2,6,2,10
"9451","10559610",0,2,0,0,0,0
"9452","10559685",0,2,0,0,0,0
"9453","10559691",0,5,6,5,0,11
"9454","10559735",0,2,2,3,0,5
"9455","10559745",0,8,1,14,0,15
"9456","10559767",0,2,1,0,0,1
"9457","10559816",0,3,2,0,0,2
"9458","10559821",0,4,0,0,1,1
"9459","10559829",0,4,5,0,0,5
"9460","10559837",0,3,0,0,0,0
"9461","10559865",0,5,4,7,0,11
"9462","10559888",0,3,2,1,0,3
"9463","10559909",0,3,0,0,0,0
"9464","10559939",0,2,0,0,0,0
"9465","10559956",0,4,4,4,0,8
"9466","10559961",0,2,1,0,0,1
"9467","10559964",0,4,5,4,0,9
"9468","10559966",0,3,0,0,0,0
"9469","10559975",0,3,2,1,0,3
"9470","10559988",0,2,0,0,0,0
"9471","10560025",0,2,0,0,0,0
"9472","10560027",0,4,0,4,0,4
"9473","10560045",0,3,0,0,0,0
"9474","10560050",0,3,0,0,0,0
"9475","10560056",0,4,0,0,0,0
"9476","10560097",0,2,0,0,0,0
"9477","10560152",0,5,5,2,0,7
"9478","10560154",0,6,7,1,1,9
"9479","10560181",0,1,1,1,0,2
"9480","10560218",0,4,6,4,2,12
"9481","10560268",0,6,1,5,0,6
"9482","10560284",0,3,3,0,0,3
"9483","10560291",0,2,2,0,0,2
"9484","10560312",0,5,8,1,1,10
"9485","10560324",0,4,4,2,0,6
"9486","10560333",0,2,0,0,0,0
"9487","10560342",0,2,0,0,0,0
"9488","10560351",0,3,0,0,0,0
"9489","10560354",0,3,8,2,0,10
"9490","10560360",0,6,8,15,2,25
"9491","10560377",0,3,3,1,0,4
"9492","10560388",0,2,4,1,0,5
"9493","10560391",0,2,0,0,0,0
"9494","10560393",0,5,1,1,0,2
"9495","10560394",0,4,2,1,0,3
"9496","10560419",0,3,1,0,0,1
"9497","10560439",0,2,0,0,0,0
"9498","10560452",0,5,3,0,0,3
"9499","10560560",0,2,1,0,0,1
"9500","10560570",0,4,3,1,2,6
"9501","10560575",0,4,0,2,0,2
"9502","10560576",0,2,0,0,0,0
"9503","10560583",0,4,8,5,0,13
"9504","10560593",0,6,0,6,5,11
"9505","10560599",0,1,0,0,0,0
"9506","10560619",0,5,3,1,0,4
"9507","10560724",0,4,2,3,0,5
"9508","10560755",0,3,4,1,0,5
"9509","10560787",0,4,10,1,0,11
"9510","10560794",0,1,0,0,0,0
"9511","10560796",0,3,0,3,0,3
"9512","10560827",0,5,2,5,0,7
"9513","10560828",0,1,0,0,0,0
"9514","10560849",0,2,1,0,0,1
"9515","10560867",0,5,2,1,0,3
"9516","10560874",0,6,3,4,0,7
"9517","10560885",0,4,0,1,0,1
"9518","10560911",0,4,2,1,1,4
"9519","10560913",0,3,0,1,0,1
"9520","10560928",0,4,0,1,0,1
"9521","10560940",1,4,0,0,0,0
"9522","10560984",0,4,1,2,0,3
"9523","10561004",0,2,0,0,0,0
"9524","10561006",0,4,2,2,0,4
"9525","10561042",0,7,6,2,0,8
"9526","10561058",0,5,0,2,0,2
"9527","10561076",0,4,2,0,1,3
"9528","10561093",0,3,0,0,0,0
"9529","10561141",0,3,1,0,0,1
"9530","10561168",0,2,0,0,0,0
"9531","10561193",0,1,0,0,0,0
"9532","10561218",0,3,0,0,0,0
"9533","10561253",0,4,2,1,0,3
"9534","10561285",0,2,0,0,0,0
"9535","10561288",0,3,0,0,0,0
"9536","10561294",0,4,3,6,0,9
"9537","10561318",0,4,3,2,0,5
"9538","10561379",0,2,0,0,0,0
"9539","10561396",0,4,1,2,0,3
"9540","10561425",0,5,4,0,0,4
"9541","10561430",1,4,1,0,0,1
"9542","10561432",0,3,4,0,0,4
"9543","10561437",0,4,0,4,0,4
"9544","10561440",0,3,0,0,0,0
"9545","10561441",0,1,0,0,0,0
"9546","10561447",0,1,1,0,0,1
"9547","10561451",0,2,0,0,0,0
"9548","10561453",0,2,0,0,0,0
"9549","10561490",0,4,6,0,0,6
"9550","10561496",0,3,0,0,0,0
"9551","10561535",0,4,0,0,0,0
"9552","10561542",0,3,3,2,0,5
"9553","10561553",0,6,7,6,0,13
"9554","10561559",0,1,1,1,0,2
"9555","10561566",0,3,6,3,0,9
"9556","10561569",0,2,1,0,0,1
"9557","10561578",0,1,0,0,0,0
"9558","10561588",0,5,0,3,0,3
"9559","10561613",0,4,1,0,0,1
"9560","10561614",0,3,1,0,0,1
"9561","10561631",0,1,0,0,0,0
"9562","10561634",0,2,0,0,0,0
"9563","10561635",0,2,3,0,0,3
"9564","10561636",0,3,3,0,0,3
"9565","10561647",0,3,8,2,0,10
"9566","10561650",0,3,1,2,0,3
"9567","10561678",0,3,2,0,0,2
"9568","10561679",0,5,0,5,0,5
"9569","10561693",0,3,4,3,0,7
"9570","10561743",0,6,3,14,3,20
"9571","10561752",0,4,2,0,0,2
"9572","10561768",0,1,0,3,0,3
"9573","10561801",0,3,0,0,0,0
"9574","10561840",0,3,6,1,0,7
"9575","10561846",0,3,3,0,0,3
"9576","10561849",0,4,0,0,0,0
"9577","10561903",0,2,1,0,0,1
"9578","10561935",0,4,7,3,0,10
"9579","10561950",0,3,0,0,0,0
"9580","10561954",0,5,3,10,2,15
"9581","10561957",0,1,0,0,0,0
"9582","10561958",0,1,1,0,0,1
"9583","10561964",0,3,0,0,0,0
"9584","10561973",0,3,0,3,0,3
"9585","10561984",0,3,0,1,0,1
"9586","10561985",0,1,0,1,0,1
"9587","10561997",0,3,8,5,0,13
"9588","10562008",0,3,0,0,0,0
"9589","10562024",0,1,0,0,0,0
"9590","10562026",0,2,0,1,0,1
"9591","10562072",0,1,0,0,0,0
"9592","10562174",0,3,0,2,0,2
"9593","10562198",0,2,0,0,0,0
"9594","10562201",0,1,0,0,0,0
"9595","10562214",0,2,0,0,0,0
"9596","10562225",0,3,0,1,0,1
"9597","10562227",0,3,1,0,0,1
"9598","10562234",0,2,0,0,0,0
"9599","10562260",1,3,2,1,0,3
"9600","10562267",0,8,17,7,1,25
"9601","10562372",0,3,1,0,0,1
"9602","10562425",0,1,0,0,0,0
"9603","10562434",0,3,3,0,0,3
"9604","10562446",0,3,0,0,0,0
"9605","10562466",0,3,2,1,0,3
"9606","10562469",0,4,5,1,0,6
"9607","10562563",0,4,5,5,0,10
"9608","10562577",0,2,0,0,0,0
"9609","10562578",0,3,2,0,0,2
"9610","10562623",0,3,1,1,0,2
"9611","10562628",0,4,7,0,0,7
"9612","10562714",0,3,1,0,0,1
"9613","10562735",0,3,1,0,0,1
"9614","10562738",0,4,0,2,0,2
"9615","10562796",0,5,3,11,0,14
"9616","10562801",0,2,0,0,0,0
"9617","10562842",0,3,3,1,0,4
"9618","10562861",0,3,2,0,0,2
"9619","10562904",0,3,0,0,0,0
"9620","10562992",0,4,2,2,0,4
"9621","10562994",0,3,8,0,0,8
"9622","10563005",0,3,1,2,0,3
"9623","10563013",0,3,0,0,0,0
"9624","10563014",0,3,0,0,0,0
"9625","10563015",0,5,2,5,2,9
"9626","10563022",0,3,2,3,0,5
"9627","10563025",0,1,1,0,0,1
"9628","10563026",0,1,0,0,0,0
"9629","10563039",0,3,0,0,0,0
"9630","10563097",0,2,0,0,0,0
"9631","10563105",0,3,4,0,0,4
"9632","10563122",0,3,0,3,0,3
"9633","10563129",0,1,0,0,0,0
"9634","10563131",0,2,0,0,0,0
"9635","10563137",0,3,2,1,0,3
"9636","10563188",0,3,1,1,0,2
"9637","10563208",0,3,6,0,0,6
"9638","10563228",0,3,4,2,0,6
"9639","10563258",0,3,3,5,0,8
"9640","10563262",0,3,0,1,0,1
"9641","10563275",0,4,7,2,0,9
"9642","10563298",0,3,0,1,0,1
"9643","10563306",0,4,2,3,0,5
"9644","10563322",0,3,0,0,0,0
"9645","10563329",0,3,0,0,0,0
"9646","10563333",0,3,4,1,0,5
"9647","10563334",0,3,2,1,0,3
"9648","10563340",0,3,4,0,0,4
"9649","10563343",0,3,4,0,0,4
"9650","10563346",0,5,4,2,0,6
"9651","10563359",0,1,0,1,0,1
"9652","10563360",0,3,0,2,0,2
"9653","10563383",0,4,1,4,0,5
"9654","10563399",0,3,0,0,0,0
"9655","10563402",0,6,0,8,4,12
"9656","10563428",0,3,5,0,0,5
"9657","10563429",0,3,3,2,0,5
"9658","10563430",0,6,10,5,1,16
"9659","10563433",0,4,7,3,0,10
"9660","10563439",0,3,0,0,0,0
"9661","10563445",0,3,1,1,0,2
"9662","10563450",0,4,1,2,0,3
"9663","10563452",0,2,3,5,0,8
"9664","10563466",0,3,0,0,0,0
"9665","10563543",0,2,0,0,0,0
"9666","10563552",0,3,0,0,0,0
"9667","10563560",0,1,0,0,0,0
"9668","10563564",0,3,0,1,0,1
"9669","10563570",0,4,2,2,0,4
"9670","10563595",0,3,0,0,0,0
"9671","10563614",0,3,0,1,0,1
"9672","10563621",0,3,4,9,1,14
"9673","10563632",0,3,4,0,0,4
"9674","10563809",0,3,0,1,0,1
"9675","10563861",1,4,0,1,3,4
"9676","10563868",0,3,2,1,0,3
"9677","10564032",0,3,1,0,0,1
"9678","10564048",0,3,2,2,0,4
"9679","10564056",0,3,0,0,0,0
"9680","10564116",0,2,1,0,0,1
"9681","10564137",0,2,3,3,0,6
"9682","10564162",0,4,1,0,0,1
"9683","10564171",0,3,0,0,0,0
"9684","10564175",0,3,0,3,0,3
"9685","10564177",0,3,4,1,0,5
"9686","10564190",0,2,0,1,0,1
"9687","10564197",0,3,8,1,0,9
"9688","10564217",0,3,0,0,0,0
"9689","10564303",0,3,0,1,0,1
"9690","10564309",0,7,6,8,2,16
"9691","10564312",0,2,0,0,0,0
"9692","10564358",0,3,0,1,0,1
"9693","10564375",0,3,1,2,0,3
"9694","10564381",0,1,0,0,0,0
"9695","10564413",0,4,3,3,0,6
"9696","10564447",0,3,1,0,0,1
"9697","10564453",0,3,2,2,0,4
"9698","10564459",0,3,1,0,0,1
"9699","10564460",0,2,1,0,0,1
"9700","10564468",0,3,0,0,0,0
"9701","10564470",0,4,1,0,0,1
"9702","10564512",1,2,0,1,0,1
"9703","10564517",0,4,2,2,1,5
"9704","10564534",0,3,2,0,0,2
"9705","10564539",0,5,1,1,1,3
"9706","10564559",0,2,2,0,0,2
"9707","10564599",0,1,0,0,0,0
"9708","10564637",0,3,0,3,0,3
"9709","10564641",0,4,1,1,1,3
"9710","10564648",0,3,2,2,0,4
"9711","10564650",0,4,0,0,0,0
"9712","10564652",0,3,0,0,0,0
"9713","10564655",0,2,0,1,0,1
"9714","10564680",0,3,0,0,0,0
"9715","10564701",0,3,1,0,0,1
"9716","10564715",0,5,2,1,0,3
"9717","10564726",0,3,0,0,0,0
"9718","10564774",0,1,0,0,0,0
"9719","10564826",0,4,0,7,0,7
"9720","10564893",0,4,4,3,2,9
"9721","10564895",0,4,0,0,0,0
"9722","10564915",0,3,0,4,0,4
"9723","10564916",0,2,1,2,0,3
"9724","10564922",0,4,1,2,0,3
"9725","10564933",0,3,1,0,0,1
"9726","10564944",0,6,4,4,1,9
"9727","10564954",0,3,2,2,0,4
"9728","10564955",0,5,2,7,1,10
"9729","10564962",0,4,2,3,0,5
"9730","10564972",0,2,2,2,0,4
"9731","10564973",0,1,0,0,0,0
"9732","10564975",0,2,4,3,0,7
"9733","10565061",0,2,0,0,0,0
"9734","10565075",0,3,0,1,0,1
"9735","10565182",0,3,3,1,0,4
"9736","10565183",0,3,0,0,0,0
"9737","10565194",0,2,1,4,0,5
"9738","10565243",0,5,2,6,1,9
"9739","10565349",0,3,1,2,0,3
"9740","10565358",0,3,2,1,0,3
"9741","10565360",0,3,1,0,0,1
"9742","10565391",0,4,2,2,0,4
"9743","10565408",0,2,0,0,0,0
"9744","10565409",0,4,3,0,0,3
"9745","10565417",0,3,0,0,0,0
"9746","10565418",0,3,1,1,0,2
"9747","10565435",0,5,12,5,1,18
"9748","10565456",0,2,0,0,0,0
"9749","10565464",0,3,1,4,0,5
"9750","10565492",0,3,1,1,0,2
"9751","10565506",0,5,1,2,0,3
"9752","10565513",0,5,3,4,0,7
"9753","10565516",0,2,4,0,0,4
"9754","10565519",0,2,1,0,0,1
"9755","10565520",0,1,0,3,0,3
"9756","10565521",0,4,9,3,0,12
"9757","10565524",0,5,0,1,0,1
"9758","10565529",0,3,0,1,0,1
"9759","10565534",0,3,0,0,0,0
"9760","10565535",0,2,1,1,0,2
"9761","10565581",0,2,0,0,0,0
"9762","10565586",0,3,1,0,0,1
"9763","10565591",0,1,1,0,0,1
"9764","10565605",0,3,0,0,0,0
"9765","10565610",0,3,3,2,0,5
"9766","10565616",0,3,4,1,0,5
"9767","10565620",0,2,4,1,0,5
"9768","10565637",0,4,6,6,0,12
"9769","10565654",0,4,2,4,0,6
"9770","10565655",0,3,0,3,0,3
"9771","10565658",0,3,0,1,0,1
"9772","10565659",0,1,2,1,0,3
"9773","10565689",0,3,0,0,0,0
"9774","10565716",0,3,1,1,0,2
"9775","10565743",0,3,3,0,0,3
"9776","10565744",0,2,0,0,0,0
"9777","10565810",0,3,1,0,0,1
"9778","10565862",0,4,2,2,0,4
"9779","10565868",0,1,3,3,0,6
"9780","10565871",0,2,1,0,0,1
"9781","10565879",0,3,2,0,0,2
"9782","10565900",0,5,5,6,1,12
"9783","10565943",0,1,0,0,0,0
"9784","10565947",0,4,0,2,1,3
"9785","10565954",0,1,2,0,0,2
"9786","10566069",0,4,4,6,0,10
"9787","10566082",0,1,2,0,0,2
"9788","10566084",0,4,1,1,0,2
"9789","10566085",0,1,0,0,0,0
"9790","10566091",0,2,0,0,0,0
"9791","10566098",0,3,2,1,0,3
"9792","10566151",0,3,3,2,0,5
"9793","10566185",0,3,0,1,0,1
"9794","10566204",0,3,0,2,0,2
"9795","10566208",0,1,0,0,0,0
"9796","10566210",0,2,2,0,0,2
"9797","10566215",1,3,0,0,0,0
"9798","10566219",0,3,10,10,0,20
"9799","10566221",0,3,0,0,0,0
"9800","10566229",0,2,0,0,0,0
"9801","10566353",1,3,2,2,0,4
"9802","10566370",0,3,1,3,0,4
"9803","10566390",0,3,2,0,0,2
"9804","10566435",0,1,2,0,0,2
"9805","10566456",0,1,0,0,0,0
"9806","10566460",0,3,1,1,0,2
"9807","10566470",0,3,2,1,0,3
"9808","10566472",0,3,2,1,0,3
"9809","10566474",0,5,6,3,2,11
"9810","10566493",0,3,0,0,0,0
"9811","10566504",0,5,9,6,1,16
"9812","10566505",0,3,0,0,0,0
"9813","10566578",0,1,0,0,0,0
"9814","10566585",0,1,0,2,0,2
"9815","10566586",0,3,3,0,0,3
"9816","10566595",0,3,0,0,0,0
"9817","10566601",0,4,3,3,2,8
"9818","10566663",0,1,0,0,0,0
"9819","10566732",0,3,0,1,0,1
"9820","10566746",0,2,1,1,0,2
"9821","10566752",0,4,5,2,0,7
"9822","10566754",0,2,0,0,0,0
"9823","10566758",0,3,0,0,0,0
"9824","10566765",0,4,0,0,0,0
"9825","10566766",0,1,0,0,0,0
"9826","10566774",0,2,0,1,0,1
"9827","10566778",0,3,0,1,0,1
"9828","10566785",0,1,0,0,0,0
"9829","10566800",0,3,0,0,0,0
"9830","10566811",0,3,0,1,0,1
"9831","10566862",0,1,0,0,0,0
"9832","10566910",0,1,1,2,0,3
"9833","10566918",0,3,0,0,0,0
"9834","10566966",0,1,0,0,0,0
"9835","10566970",0,3,2,1,0,3
"9836","10567027",0,2,3,3,0,6
"9837","10567043",0,1,0,0,0,0
"9838","10567056",0,4,5,3,0,8
"9839","10567057",0,3,4,2,0,6
"9840","10567058",0,3,4,1,0,5
"9841","10567081",0,3,3,0,0,3
"9842","10567082",0,3,0,0,0,0
"9843","10567111",0,3,0,0,0,0
"9844","10567114",0,3,1,0,0,1
"9845","10567122",1,3,0,3,0,3
"9846","10567164",0,5,1,3,1,5
"9847","10567166",0,2,2,0,0,2
"9848","10567169",0,3,1,0,0,1
"9849","10567173",0,3,1,0,0,1
"9850","10567249",1,3,0,0,0,0
"9851","10567280",0,3,0,2,1,3
"9852","10567359",0,3,1,0,0,1
"9853","10567361",0,2,2,0,0,2
"9854","10567362",0,3,0,0,0,0
"9855","10567363",0,3,1,0,0,1
"9856","10567366",0,3,0,0,0,0
"9857","10567369",0,3,1,1,0,2
"9858","10567373",0,3,0,1,0,1
"9859","10567384",0,3,7,6,0,13
"9860","10567390",0,3,1,0,0,1
"9861","10567394",0,4,5,6,2,13
"9862","10567405",0,3,0,2,0,2
"9863","10567527",0,4,2,2,0,4
"9864","10567541",0,5,0,3,0,3
"9865","10567576",0,6,6,4,1,11
"9866","10567601",0,4,3,2,1,6
"9867","10567606",0,3,4,1,0,5
"9868","10567622",0,3,2,4,0,6
"9869","10567640",0,2,2,1,0,3
"9870","10567684",0,3,0,2,0,2
"9871","10567696",0,3,0,0,0,0
"9872","10567707",0,3,0,1,0,1
"9873","10567711",0,1,0,0,0,0
"9874","10567712",0,1,1,1,0,2
"9875","10567717",0,4,2,3,2,7
"9876","10567724",0,3,2,2,0,4
"9877","10567730",0,2,0,0,0,0
"9878","10567732",0,3,0,1,0,1
"9879","10567739",0,3,3,0,0,3
"9880","10567818",0,2,1,0,1,2
"9881","10567832",0,2,1,0,0,1
"9882","10567899",0,3,0,2,0,2
"9883","10567909",0,4,0,0,0,0
"9884","10567914",0,2,0,0,0,0
"9885","10567945",0,3,2,2,0,4
"9886","10567969",0,5,5,5,0,10
"9887","10567974",0,2,2,0,0,2
"9888","10567982",0,2,1,1,0,2
"9889","10567997",0,3,0,0,0,0
"9890","10568000",0,3,0,0,0,0
"9891","10568010",0,3,0,0,0,0
"9892","10568015",0,2,0,1,0,1
"9893","10568020",0,2,1,1,0,2
"9894","10568026",0,3,2,1,0,3
"9895","10568033",0,3,0,0,0,0
"9896","10568072",0,2,0,0,0,0
"9897","10568076",0,3,1,1,0,2
"9898","10568080",0,2,0,0,0,0
"9899","10568096",0,1,0,0,0,0
"9900","10568158",0,2,2,1,0,3
"9901","10568179",0,3,3,2,0,5
"9902","10568181",0,3,1,0,0,1
"9903","10568198",0,2,1,0,0,1
"9904","10568201",0,4,4,2,0,6
"9905","10568203",0,2,0,0,0,0
"9906","10568255",0,3,3,2,0,5
"9907","10568262",0,3,2,0,0,2
"9908","10568266",0,4,0,1,0,1
"9909","10568268",0,1,1,1,0,2
"9910","10568273",0,3,3,2,0,5
"9911","10568301",0,2,0,0,0,0
"9912","10568311",0,3,2,1,0,3
"9913","10568351",0,3,3,1,0,4
"9914","10568363",0,3,5,6,0,11
"9915","10568444",0,4,7,5,0,12
"9916","10568453",0,1,0,0,0,0
"9917","10568458",0,3,0,0,0,0
"9918","10568468",0,1,0,0,0,0
"9919","10568477",0,3,0,0,0,0
"9920","10568480",0,2,0,0,0,0
"9921","10568489",0,2,0,3,0,3
"9922","10568498",0,2,0,0,0,0
"9923","10568512",0,1,1,0,0,1
"9924","10568527",0,3,0,0,0,0
"9925","10568571",0,3,7,7,0,14
"9926","10568577",0,4,6,6,1,13
"9927","10568587",0,2,0,0,0,0
"9928","10568604",0,4,4,5,0,9
"9929","10568609",0,3,3,2,0,5
"9930","10568614",0,1,0,0,0,0
"9931","10568621",0,3,1,0,0,1
"9932","10568628",0,4,3,2,0,5
"9933","10568657",0,2,0,0,0,0
"9934","10568659",0,1,0,0,0,0
"9935","10568668",0,2,0,1,0,1
"9936","10568669",0,3,2,1,0,3
"9937","10568676",0,3,1,2,0,3
"9938","10568677",0,2,1,1,0,2
"9939","10568760",0,3,0,0,0,0
"9940","10568761",0,2,0,0,0,0
"9941","10568777",0,4,11,7,2,20
"9942","10568812",0,4,9,2,0,11
"9943","10568875",0,2,0,0,0,0
"9944","10568889",0,3,1,0,0,1
"9945","10568893",0,1,1,0,0,1
"9946","10568935",0,3,1,0,0,1
"9947","10568939",0,3,0,3,0,3
"9948","10568945",0,3,0,2,0,2
"9949","10568991",0,3,1,2,0,3
"9950","10568995",0,2,1,0,0,1
"9951","10569017",0,4,0,0,0,0
"9952","10569029",0,3,2,2,0,4
"9953","10569065",1,6,2,1,0,3
"9954","10569106",0,3,2,0,0,2
"9955","10569143",0,7,6,9,1,16
"9956","10569205",0,6,8,4,1,13
"9957","10569212",0,3,2,1,0,3
"9958","10569273",0,3,5,2,0,7
"9959","10569283",0,1,0,0,0,0
"9960","10569288",0,2,0,0,0,0
"9961","10569318",0,3,1,0,0,1
"9962","10569323",0,4,0,2,0,2
"9963","10569332",0,3,0,0,0,0
"9964","10569337",0,6,7,5,0,12
"9965","10569363",1,2,1,1,0,2
"9966","10569366",0,3,2,0,0,2
"9967","10569370",0,4,2,2,0,4
"9968","10569376",1,3,0,0,0,0
"9969","10569396",0,2,0,0,0,0
"9970","10569411",0,1,0,0,0,0
"9971","10569413",0,4,3,3,1,7
"9972","10569444",0,2,0,0,0,0
"9973","10569457",0,3,0,0,0,0
"9974","10569465",0,3,2,4,0,6
"9975","10569475",0,4,4,4,0,8
"9976","10569483",0,4,0,4,0,4
"9977","10569486",0,3,1,1,0,2
"9978","10569487",0,2,0,0,0,0
"9979","10569489",0,3,1,3,0,4
"9980","10569547",0,2,0,0,0,0
"9981","10569598",0,5,1,5,0,6
"9982","10569643",0,2,0,0,0,0
"9983","10569646",0,1,0,0,0,0
"9984","10569650",0,3,0,3,0,3
"9985","10569651",0,1,0,0,0,0
"9986","10569678",0,1,0,0,0,0
"9987","10569694",0,1,0,0,0,0
"9988","10569698",0,1,0,0,0,0
"9989","10569702",0,1,0,0,0,0
"9990","10569756",0,3,3,3,0,6
"9991","10569790",0,4,0,4,0,4
"9992","10569793",0,3,1,1,0,2
"9993","10569892",0,2,0,2,0,2
"9994","10569894",0,2,1,2,0,3
"9995","10569916",0,2,2,1,0,3
"9996","10569922",0,1,0,0,0,0
"9997","10569926",0,2,1,0,0,1
"9998","10569944",0,1,0,0,0,0
"9999","10569948",0,3,2,9,2,13
"10000","10569950",0,2,1,0,0,1
"10001","10569952",0,4,0,0,0,0
"10002","10569958",1,4,0,2,0,2
"10003","10569976",0,2,4,1,0,5
"10004","10569986",0,2,0,2,0,2
"10005","10570000",0,5,4,2,3,9
"10006","10570002",0,3,0,4,0,4
"10007","10570055",0,3,1,2,0,3
"10008","10570065",0,3,1,0,0,1
"10009","10570074",0,5,4,8,0,12
"10010","10570075",0,3,0,7,0,7
"10011","10570195",0,4,2,1,0,3
"10012","10570216",0,5,0,3,2,5
"10013","10570234",0,3,1,1,0,2
"10014","10570236",0,4,1,9,1,11
"10015","10570237",0,1,0,0,0,0
"10016","10570239",0,1,0,0,0,0
"10017","10570254",0,3,2,1,0,3
"10018","10570346",0,4,0,1,0,1
"10019","10570347",0,2,0,0,0,0
"10020","10570350",0,3,0,0,0,0
"10021","10570367",0,3,0,0,0,0
"10022","10570530",0,1,0,0,0,0
"10023","10570534",0,3,0,1,0,1
"10024","10570537",0,5,6,4,1,11
"10025","10570549",0,2,2,0,0,2
"10026","10570554",0,2,0,0,0,0
"10027","10570561",0,3,1,0,0,1
"10028","10570636",0,3,4,4,0,8
"10029","10570671",0,2,0,0,0,0
"10030","10570675",0,3,1,1,0,2
"10031","10570689",0,3,1,0,0,1
"10032","10570793",0,4,0,1,1,2
"10033","10570814",0,4,2,2,0,4
"10034","10570815",0,2,0,0,0,0
"10035","10570888",0,2,0,0,0,0
"10036","10570889",0,3,0,0,0,0
"10037","10570890",0,3,0,3,0,3
"10038","10570911",1,4,4,8,0,12
"10039","10570959",0,2,1,1,0,2
"10040","10570984",0,1,0,0,0,0
"10041","10571006",0,2,1,0,0,1
"10042","10571027",0,2,1,0,0,1
"10043","10571055",0,2,4,2,0,6
"10044","10571075",0,4,0,1,0,1
"10045","10571088",0,5,4,4,2,10
"10046","10571100",0,3,0,1,0,1
"10047","10571105",0,3,0,1,0,1
"10048","10571106",0,2,0,0,0,0
"10049","10571149",0,2,0,0,0,0
"10050","10571175",0,1,0,0,0,0
"10051","10571176",0,2,1,0,0,1
"10052","10571180",0,2,0,0,0,0
"10053","10571281",0,4,6,2,0,8
"10054","10571330",0,1,0,0,0,0
"10055","10571333",0,3,1,1,0,2
"10056","10571367",0,3,0,0,0,0
"10057","10571371",0,7,8,8,2,18
"10058","10571377",0,4,1,1,0,2
"10059","10571413",0,2,0,1,0,1
"10060","10571464",0,2,0,0,0,0
"10061","10571465",0,3,0,1,0,1
"10062","10571466",0,4,2,1,0,3
"10063","10571482",0,3,0,2,0,2
"10064","10571501",0,3,1,1,0,2
"10065","10571506",0,2,0,0,0,0
"10066","10571538",0,4,1,0,0,1
"10067","10571592",0,4,6,0,0,6
"10068","10571629",0,1,2,0,0,2
"10069","10571657",0,3,2,6,0,8
"10070","10571662",0,2,0,0,0,0
"10071","10571691",0,2,0,0,0,0
"10072","10571695",0,2,0,0,0,0
"10073","10571715",0,3,0,0,0,0
"10074","10571718",0,3,0,0,0,0
"10075","10571721",0,3,1,6,0,7
"10076","10571731",0,2,0,0,0,0
"10077","10571756",0,1,0,1,0,1
"10078","10571761",0,2,0,3,0,3
"10079","10571762",0,3,1,0,0,1
"10080","10571779",0,6,5,9,5,19
"10081","10571793",0,2,5,1,0,6
"10082","10571809",0,1,0,0,0,0
"10083","10571819",0,1,0,0,0,0
"10084","10571843",0,4,2,3,1,6
"10085","10571845",0,3,7,1,0,8
"10086","10571851",0,1,0,0,0,0
"10087","10571853",0,3,0,2,0,2
"10088","10571864",0,2,0,0,0,0
"10089","10571871",0,2,0,0,0,0
"10090","10571884",0,4,5,3,0,8
"10091","10571893",0,2,0,3,0,3
"10092","10571903",0,3,4,2,0,6
"10093","10571969",0,2,1,1,0,2
"10094","10571970",0,2,0,2,0,2
"10095","10571971",0,1,0,0,0,0
"10096","10571977",0,2,0,0,0,0
"10097","10572014",0,1,0,0,0,0
"10098","10572020",0,3,3,4,0,7
"10099","10572026",0,4,3,1,1,5
"10100","10572036",0,2,0,1,0,1
"10101","10572039",0,4,2,6,0,8
"10102","10572047",0,3,0,0,0,0
"10103","10572050",0,4,3,8,2,13
"10104","10572064",0,3,2,1,0,3
"10105","10572068",0,2,2,4,0,6
"10106","10572078",0,1,0,0,0,0
"10107","10572098",0,3,0,0,1,1
"10108","10572121",0,1,1,1,0,2
"10109","10572173",0,5,8,2,0,10
"10110","10572224",0,5,1,2,3,6
"10111","10572240",0,3,3,4,0,7
"10112","10572244",0,3,1,2,0,3
"10113","10572251",0,2,0,2,0,2
"10114","10572403",0,2,2,0,0,2
"10115","10572431",0,2,1,0,0,1
"10116","10572439",0,1,0,0,0,0
"10117","10572448",0,1,0,0,0,0
"10118","10572454",0,1,0,0,0,0
"10119","10572466",0,1,0,0,0,0
"10120","10572470",0,2,0,0,0,0
"10121","10572477",0,3,0,3,0,3
"10122","10572484",0,2,0,0,0,0
"10123","10572492",0,3,2,3,0,5
"10124","10572505",0,2,0,0,0,0
"10125","10572547",0,2,0,0,0,0
"10126","10572600",0,3,1,0,0,1
"10127","10572602",0,2,4,3,0,7
"10128","10572608",0,2,0,0,0,0
"10129","10572609",0,2,0,0,0,0
"10130","10572630",0,2,0,0,0,0
"10131","10572721",0,3,0,0,0,0
"10132","10572737",0,1,0,0,0,0
"10133","10572803",0,2,0,0,0,0
"10134","10572851",0,2,0,1,0,1
"10135","10572889",0,3,1,2,0,3
"10136","10572909",0,4,5,4,0,9
"10137","10572925",0,2,0,0,0,0
"10138","10573015",0,3,2,0,3,5
"10139","10573111",0,1,0,0,0,0
"10140","10573122",0,2,2,3,0,5
"10141","10573185",0,4,0,2,0,2
"10142","10573191",0,2,0,0,0,0
"10143","10573234",0,2,0,0,0,0
"10144","10573235",0,2,1,3,0,4
"10145","10573236",0,2,0,0,0,0
"10146","10573253",0,2,0,0,0,0
"10147","10573268",0,2,2,2,0,4
"10148","10573274",0,2,0,1,0,1
"10149","10573278",0,2,0,0,0,0
"10150","10573321",0,2,2,6,0,8
"10151","10573393",0,1,0,0,0,0
"10152","10573394",0,3,3,3,0,6
"10153","10573400",0,3,4,0,0,4
"10154","10573412",0,1,0,0,0,0
"10155","10573495",0,4,8,3,0,11
"10156","10573496",0,3,0,3,0,3
"10157","10573521",0,2,0,0,0,0
"10158","10573530",0,5,1,2,1,4
"10159","10573542",0,1,1,1,0,2
"10160","10573546",0,2,0,0,0,0
"10161","10573590",0,2,1,2,0,3
"10162","10573611",1,2,0,0,0,0
"10163","10573753",0,1,0,0,0,0
"10164","10573772",0,3,5,5,1,11
"10165","10573773",0,1,0,0,0,0
"10166","10573776",0,2,0,0,0,0
"10167","10573779",0,2,2,0,0,2
"10168","10573848",0,3,0,1,1,2
"10169","10573867",0,2,0,0,0,0
"10170","10573894",0,2,0,0,0,0
"10171","10573895",0,3,6,6,4,16
"10172","10573896",0,4,5,2,0,7
"10173","10573974",0,2,0,0,0,0
"10174","10573982",0,2,1,0,0,1
"10175","10573991",0,2,0,0,0,0
"10176","10573993",0,3,0,0,0,0
"10177","10574035",0,2,4,5,0,9
"10178","10574040",0,2,1,0,0,1
"10179","10574053",0,2,3,4,0,7
"10180","10574066",0,2,1,0,0,1
"10181","10574120",0,2,0,0,0,0
"10182","10574131",0,7,8,7,1,16
"10183","10574133",0,2,0,0,0,0
"10184","10574136",0,2,0,0,0,0
"10185","10574139",0,2,1,0,0,1
"10186","10574141",0,2,0,0,0,0
"10187","10574143",0,2,0,0,0,0
"10188","10574144",0,2,0,0,0,0
"10189","10574145",0,1,0,0,0,0
"10190","10574146",0,2,0,1,0,1
"10191","10574160",0,2,1,0,0,1
"10192","10574171",0,2,1,2,0,3
"10193","10574188",0,2,0,0,0,0
"10194","10574207",0,1,0,0,0,0
"10195","10574272",1,2,0,0,0,0
"10196","10574291",0,2,2,1,0,3
"10197","10574361",0,2,0,0,0,0
"10198","10574379",0,3,1,1,0,2
"10199","10574384",0,2,0,0,0,0
"10200","10574443",0,6,2,6,2,10
"10201","10574461",0,2,0,1,0,1
"10202","10574478",0,2,0,0,0,0
"10203","10574479",0,2,1,2,0,3
"10204","10574483",0,3,4,3,1,8
"10205","10574491",0,2,1,2,0,3
"10206","10574495",0,2,3,3,0,6
"10207","10574504",0,3,0,1,0,1
"10208","10574517",0,1,0,0,0,0
"10209","10574542",0,3,0,0,0,0
"10210","10574559",0,2,0,0,0,0
"10211","10574567",0,2,0,0,0,0
"10212","10574581",0,3,0,1,0,1
"10213","10574589",0,2,1,0,0,1
"10214","10574602",0,2,1,2,0,3
"10215","10574614",0,3,4,3,0,7
"10216","10574637",0,2,1,0,0,1
"10217","10574642",1,2,0,1,0,1
"10218","10574659",0,3,0,1,0,1
"10219","10574677",0,2,2,2,2,6
"10220","10574690",0,2,0,0,0,0
"10221","10574697",0,2,1,0,0,1
"10222","10574701",0,3,1,4,2,7
"10223","10574708",0,2,0,0,0,0
"10224","10574709",0,2,0,3,0,3
"10225","10574712",0,3,0,0,0,0
"10226","10574717",0,2,0,0,0,0
"10227","10574723",0,4,2,3,1,6
"10228","10574727",0,3,1,0,0,1
"10229","10574739",1,1,0,0,0,0
"10230","10574765",0,2,0,0,0,0
"10231","10574767",0,3,1,2,0,3
"10232","10574769",0,2,0,1,0,1
"10233","10574777",0,2,0,0,0,0
"10234","10574784",0,4,1,5,0,6
"10235","10574816",0,2,0,0,0,0
"10236","10574823",0,2,0,0,0,0
"10237","10574836",0,2,0,0,0,0
"10238","10574846",0,2,0,0,0,0
"10239","10574849",0,2,0,0,0,0
"10240","10574851",0,2,2,0,0,2
"10241","10574909",0,2,0,0,0,0
"10242","10574913",0,1,0,0,0,0
"10243","10574914",0,2,3,1,0,4
"10244","10574916",0,2,1,0,0,1
"10245","10575042",0,2,0,0,0,0
"10246","10575044",0,3,0,3,1,4
"10247","10575049",0,2,0,3,0,3
"10248","10575059",0,1,0,0,0,0
"10249","10575062",0,6,7,2,1,10
"10250","10575087",0,2,0,1,0,1
"10251","10575101",0,2,0,0,0,0
"10252","10575127",0,2,0,2,0,2
"10253","10575135",0,3,2,4,1,7
"10254","10575145",0,2,1,0,0,1
"10255","10575150",0,2,2,0,0,2
"10256","10575158",0,2,0,0,0,0
"10257","10575162",0,1,0,0,0,0
"10258","10575183",0,2,0,3,0,3
"10259","10575185",0,2,0,1,0,1
"10260","10575200",0,1,0,0,0,0
"10261","10575233",0,2,0,0,0,0
"10262","10575256",0,1,0,0,0,0
"10263","10575259",1,2,1,4,0,5
"10264","10575274",0,1,0,0,0,0
"10265","10575293",0,2,0,0,0,0
"10266","10575300",0,1,0,0,0,0
"10267","10575305",0,3,0,0,0,0
"10268","10575370",0,1,0,0,0,0
"10269","10575375",0,4,0,2,1,3
"10270","10575376",0,1,0,0,0,0
"10271","10575378",0,5,0,1,0,1
"10272","10575381",0,1,2,4,0,6
"10273","10575383",0,3,1,1,0,2
"10274","10575387",0,2,0,0,0,0
"10275","10575388",0,2,2,1,0,3
"10276","10575389",0,3,0,1,0,1
"10277","10575412",0,2,0,0,0,0
"10278","10575419",0,3,0,1,0,1
"10279","10575421",0,2,1,0,0,1
"10280","10575427",0,3,1,1,0,2
"10281","10575452",0,2,2,0,0,2
"10282","10575508",0,3,1,0,0,1
"10283","10575523",0,2,0,0,0,0
"10284","10575524",0,2,0,1,0,1
"10285","10575527",0,3,3,4,0,7
"10286","10575535",0,3,4,2,0,6
"10287","10575589",0,2,1,1,0,2
"10288","10575599",0,1,0,0,0,0
"10289","10575611",0,2,0,3,0,3
"10290","10575621",0,2,0,0,0,0
"10291","10575671",0,3,0,0,0,0
"10292","10575689",0,2,1,1,0,2
"10293","10575719",0,4,4,7,1,12
"10294","10575733",0,2,0,0,0,0
"10295","10575740",0,2,0,1,0,1
"10296","10575809",0,2,1,0,0,1
"10297","10575810",0,3,1,2,1,4
"10298","10575836",0,2,0,0,0,0
"10299","10575838",0,2,1,0,0,1
"10300","10575883",0,2,0,0,0,0
"10301","10575896",0,3,7,5,0,12
"10302","10575900",0,1,0,0,0,0
"10303","10575901",0,2,1,2,0,3
"10304","10575908",0,2,0,0,0,0
"10305","10575918",0,2,1,1,0,2
"10306","10575921",0,2,1,0,0,1
"10307","10575934",0,3,1,2,0,3
"10308","10575936",0,2,0,0,0,0
"10309","10575952",0,1,0,0,0,0
"10310","10575953",0,2,0,0,0,0
"10311","10575955",0,2,0,0,0,0
"10312","10575961",0,1,0,0,0,0
"10313","10575965",0,2,0,0,0,0
"10314","10575969",0,3,4,0,0,4
"10315","10575982",0,2,1,0,0,1
"10316","10576000",0,2,0,0,0,0
"10317","10576014",0,3,4,0,0,4
"10318","10576018",0,4,5,3,0,8
"10319","10576021",0,3,2,2,1,5
"10320","10576022",0,3,0,2,0,2
"10321","10576072",0,4,4,6,4,14
"10322","10576082",0,2,1,0,0,1
"10323","10576091",0,3,1,5,0,6
"10324","10576092",0,2,0,0,0,0
"10325","10576101",0,2,0,1,0,1
"10326","10576112",0,2,5,0,0,5
"10327","10576116",0,3,0,1,0,1
"10328","10576122",1,3,0,0,0,0
"10329","10576194",0,4,2,3,1,6
"10330","10576198",0,2,0,0,0,0
"10331","10576214",0,2,0,0,0,0
"10332","10576279",0,2,0,0,0,0
"10333","10576284",0,4,3,8,1,12
"10334","10576301",0,1,0,0,0,0
"10335","10576302",0,1,0,1,0,1
"10336","10576306",1,2,0,0,0,0
"10337","10576314",0,2,0,1,0,1
"10338","10576318",0,2,1,0,0,1
"10339","10576320",0,2,1,1,0,2
"10340","10576325",0,2,0,1,0,1
"10341","10576335",0,1,0,0,0,0
"10342","10576338",0,2,0,0,0,0
"10343","10576339",0,2,0,2,0,2
"10344","10576354",0,2,0,0,0,0
"10345","10576370",0,2,0,0,0,0
"10346","10576371",0,3,4,2,0,6
"10347","10576372",0,2,1,0,0,1
"10348","10576374",0,1,1,1,0,2
"10349","10576375",0,2,0,1,0,1
"10350","10576382",0,2,0,0,0,0
"10351","10576391",0,2,0,1,0,1
"10352","10576442",0,2,0,0,0,0
"10353","10576446",0,5,8,16,1,25
"10354","10576452",0,2,2,2,0,4
"10355","10576467",0,2,0,0,0,0
"10356","10576502",0,1,0,0,0,0
"10357","10576562",0,2,0,0,0,0
"10358","10576564",0,2,0,0,0,0
"10359","10576566",0,1,2,0,0,2
"10360","10576567",0,1,0,0,0,0
"10361","10576570",0,1,0,0,0,0
"10362","10576576",0,2,1,0,0,1
"10363","10576585",0,2,0,0,0,0
"10364","10576586",0,3,0,2,0,2
"10365","10576615",0,2,0,0,0,0
"10366","10576620",0,2,0,0,0,0
"10367","10576638",0,1,0,0,0,0
"10368","10576651",0,2,0,0,0,0
"10369","10576686",0,1,0,0,0,0
"10370","10576692",0,3,1,2,0,3
"10371","10576702",0,2,0,0,0,0
"10372","10576709",0,1,0,0,0,0
"10373","10576712",0,1,2,2,0,4
"10374","10576713",0,3,1,4,0,5
"10375","10576714",0,2,0,0,0,0
"10376","10576719",0,2,2,0,0,2
"10377","10576720",0,3,1,2,1,4
"10378","10576733",0,1,0,0,0,0
"10379","10576796",1,2,0,1,0,1
"10380","10576806",0,1,0,0,0,0
"10381","10576820",0,2,0,0,0,0
"10382","10576827",0,2,0,2,0,2
"10383","10576832",0,2,0,2,0,2
"10384","10576865",0,2,1,1,0,2
"10385","10576867",0,1,0,0,0,0
"10386","10576868",0,2,0,2,0,2
"10387","10576870",0,3,0,4,0,4
"10388","10576903",0,2,0,1,0,1
"10389","10576919",0,3,1,3,1,5
"10390","10576947",0,1,0,0,0,0
"10391","10576960",0,1,0,0,0,0
"10392","10576962",0,2,0,0,0,0
"10393","10576966",0,3,2,6,0,8
"10394","10577004",0,2,2,1,0,3
"10395","10577050",0,2,3,1,0,4
"10396","10577063",0,2,1,0,0,1
"10397","10577065",0,1,0,1,0,1
"10398","10577066",0,2,2,0,0,2
"10399","10577067",0,2,0,0,0,0
"10400","10577078",0,2,0,0,0,0
"10401","10577079",0,1,1,0,0,1
"10402","10577080",0,1,0,0,0,0
"10403","10577081",0,2,0,0,0,0
"10404","10577089",1,5,4,3,1,8
"10405","10577100",0,2,0,1,0,1
"10406","10577120",0,2,0,0,0,0
"10407","10577123",0,3,3,2,0,5
"10408","10577125",0,3,3,1,0,4
"10409","10577129",0,1,0,0,0,0
"10410","10577138",0,2,0,0,0,0
"10411","10577140",0,2,0,0,0,0
"10412","10577157",1,2,0,1,0,1
"10413","10577158",0,2,2,0,0,2
"10414","10577183",0,1,0,0,0,0
"10415","10577225",0,3,0,0,0,0
"10416","10577280",0,2,0,0,0,0
"10417","10577284",0,2,0,0,0,0
"10418","10577285",0,3,7,7,0,14
"10419","10577286",0,2,0,0,0,0
"10420","10577302",0,1,0,0,0,0
"10421","10577303",0,2,0,0,0,0
"10422","10577312",0,3,0,4,1,5
"10423","10577314",0,2,0,0,0,0
"10424","10577335",0,2,0,0,0,0
"10425","10577337",0,2,4,1,0,5
"10426","10577341",0,5,0,7,0,7
"10427","10577346",0,2,0,2,0,2
"10428","10577347",0,1,0,0,0,0
"10429","10577389",0,2,0,0,0,0
"10430","10577397",0,2,0,0,0,0
"10431","10577410",0,3,0,1,0,1
"10432","10577414",0,1,0,0,0,0
"10433","10577415",0,2,0,0,0,0
"10434","10577421",0,2,1,1,0,2
"10435","10577422",0,3,0,3,1,4
"10436","10577433",0,3,0,1,0,1
"10437","10577437",0,2,0,0,0,0
"10438","10577442",0,3,0,0,0,0
"10439","10577445",0,2,0,0,0,0
"10440","10577448",0,2,0,0,0,0
"10441","10577451",0,2,1,1,0,2
"10442","10577456",0,3,0,0,0,0
"10443","10577462",0,2,2,0,0,2
"10444","10577464",0,1,0,0,0,0
"10445","10577475",0,3,0,0,0,0
"10446","10577483",0,2,0,0,0,0
"10447","10577488",0,2,0,0,0,0
"10448","10577490",0,1,0,0,0,0
"10449","10577498",0,1,1,0,0,1
"10450","10577500",0,1,0,0,0,0
"10451","10577503",0,2,0,0,0,0
"10452","10577532",0,2,0,1,0,1
"10453","10577534",0,1,0,0,0,0
"10454","10577562",0,2,1,2,0,3
"10455","10577573",1,2,0,0,0,0
"10456","10577584",0,2,2,2,0,4
"10457","10577585",0,1,0,4,0,4
"10458","10577588",0,3,2,1,0,3
"10459","10577590",0,3,0,0,0,0
"10460","10577592",0,3,1,2,0,3
"10461","10577598",0,2,1,1,0,2
"10462","10577601",0,2,1,1,0,2
"10463","10577602",0,2,0,0,0,0
"10464","10577614",0,2,0,0,0,0
"10465","10577615",0,2,2,1,0,3
"10466","10577630",0,2,1,1,0,2
"10467","10577631",0,2,0,3,0,3
"10468","10577639",0,2,1,0,0,1
"10469","10577643",0,1,0,0,0,0
"10470","10577657",0,2,0,1,0,1
"10471","10577659",0,2,1,0,0,1
"10472","10577696",0,2,0,0,0,0
"10473","10577707",0,3,0,0,0,0
"10474","10577712",0,3,2,0,0,2
"10475","10577728",0,2,1,2,0,3
"10476","10577747",0,2,1,0,0,1
"10477","10577761",0,2,2,1,0,3
"10478","10577790",0,2,0,0,0,0
"10479","10577799",0,2,0,0,0,0
"10480","10577822",0,2,0,0,0,0
"10481","10577826",0,3,2,5,1,8
"10482","10577861",0,2,0,0,0,0
"10483","10577864",0,2,0,0,0,0
"10484","10577873",0,2,0,0,0,0
"10485","10577878",0,2,0,0,0,0
"10486","10577881",0,2,0,0,0,0
"10487","10577897",0,1,0,0,0,0
"10488","10577904",0,2,0,1,0,1
"10489","10577908",0,3,0,3,0,3
"10490","10577911",0,2,3,0,0,3
"10491","10577931",0,2,0,0,0,0
"10492","10577940",0,2,2,1,0,3
"10493","10577950",0,1,0,0,0,0
"10494","10577954",0,3,0,1,0,1
"10495","10577955",0,2,0,0,0,0
"10496","10577957",0,2,1,1,0,2
"10497","10577967",0,2,1,1,0,2
"10498","10578030",0,2,0,0,0,0
"10499","10578071",0,2,0,0,0,0
"10500","10578073",0,2,1,0,0,1
"10501","10578099",0,4,2,3,1,6
"10502","10578134",0,1,0,0,0,0
"10503","10578137",0,2,1,1,0,2
"10504","10578143",0,1,0,0,0,0
"10505","10578145",0,3,0,3,1,4
"10506","10578162",0,2,3,1,0,4
"10507","10578172",0,2,1,1,0,2
"10508","10578174",0,2,1,0,0,1
"10509","10578175",0,2,0,0,0,0
"10510","10578176",0,2,0,0,0,0
"10511","10578177",0,2,0,0,0,0
"10512","10578198",0,2,0,0,0,0
"10513","10578199",0,2,2,0,0,2
"10514","10578230",0,1,1,2,0,3
"10515","10578267",0,1,1,0,0,1
"10516","10578279",0,2,0,0,0,0
"10517","10578294",0,2,0,0,0,0
"10518","10578296",0,2,0,0,0,0
"10519","10578302",0,1,1,1,0,2
"10520","10578306",0,2,2,0,0,2
"10521","10578307",0,4,4,3,0,7
"10522","10578308",0,2,1,1,0,2
"10523","10578313",0,2,0,0,0,0
"10524","10578318",0,1,1,0,0,1
"10525","10578328",0,3,1,1,2,4
"10526","10578363",0,2,0,0,0,0
"10527","10578373",0,1,0,0,0,0
"10528","10578379",0,2,0,0,0,0
"10529","10578384",0,3,0,0,0,0
"10530","10578386",0,3,0,2,2,4
"10531","10578388",0,2,0,4,0,4
"10532","10578394",0,1,0,0,0,0
"10533","10578399",0,2,1,0,0,1
"10534","10578403",0,2,0,0,0,0
"10535","10578430",0,2,1,0,0,1
"10536","10578474",0,2,0,0,0,0
"10537","10578477",0,2,7,0,0,7
"10538","10578491",0,1,0,0,0,0
"10539","10578528",0,3,6,4,0,10
"10540","10578538",0,2,2,4,1,7
"10541","10578556",0,2,1,0,0,1
"10542","10578557",0,2,0,1,0,1
"10543","10578559",0,2,1,0,0,1
"10544","10578560",0,5,3,8,2,13
"10545","10578566",0,2,0,0,0,0
"10546","10578605",0,2,2,0,0,2
"10547","10578631",0,2,2,2,0,4
"10548","10578636",0,2,0,0,0,0
"10549","10578654",0,6,3,9,1,13
"10550","10578660",0,2,0,0,0,0
"10551","10578661",0,2,0,0,0,0
"10552","10578663",0,2,0,0,0,0
"10553","10578670",0,1,0,0,0,0
"10554","10578677",0,2,0,1,0,1
"10555","10578680",0,2,0,0,0,0
"10556","10578681",0,3,4,0,0,4
"10557","10578698",0,3,1,0,1,2
"10558","10578770",0,2,3,1,0,4
"10559","10578822",0,2,0,0,0,0
"10560","10578824",0,2,2,1,0,3
"10561","10578827",0,1,0,0,0,0
"10562","10578833",0,1,1,0,0,1
"10563","10578835",0,2,0,0,0,0
"10564","10578837",0,1,0,0,0,0
"10565","10578839",0,1,0,3,0,3
"10566","10578844",0,1,0,0,0,0
"10567","10578845",0,1,0,0,0,0
"10568","10578847",0,2,4,2,0,6
"10569","10578849",0,1,0,0,0,0
"10570","10578860",0,2,0,0,0,0
"10571","10578884",0,4,3,1,0,4
"10572","10578885",0,3,4,4,0,8
"10573","10578890",0,2,0,0,0,0
"10574","10578891",0,2,0,0,0,0
"10575","10578896",0,3,0,1,0,1
"10576","10578897",0,2,0,0,0,0
"10577","10578927",0,2,0,0,0,0
"10578","10578980",0,1,0,0,0,0
"10579","10579020",0,3,2,2,0,4
"10580","10579041",0,2,0,0,0,0
"10581","10579103",0,2,1,0,0,1
"10582","10579115",0,2,4,1,0,5
"10583","10579181",0,2,0,0,0,0
"10584","10579201",0,3,6,6,0,12
"10585","10579219",0,3,4,7,0,11
"10586","10579234",0,2,0,2,0,2
"10587","10579236",0,2,0,0,0,0
"10588","10579237",0,2,0,0,0,0
"10589","10579251",0,1,0,0,0,0
"10590","10579252",0,2,1,0,0,1
"10591","10579262",0,3,3,1,0,4
"10592","10579283",0,2,1,1,0,2
"10593","10579289",0,2,0,0,0,0
"10594","10579303",0,3,0,3,0,3
"10595","10579317",0,2,0,0,0,0
"10596","10579320",0,2,0,0,0,0
"10597","10579323",1,3,1,1,0,2
"10598","10579326",0,1,2,2,0,4
"10599","10579331",0,2,0,0,0,0
"10600","10579333",0,2,0,0,0,0
"10601","10579380",0,2,0,0,0,0
"10602","10579403",0,1,0,0,0,0
"10603","10579408",0,1,0,0,0,0
"10604","10579411",0,3,2,1,0,3
"10605","10579417",0,2,1,1,0,2
"10606","10579419",0,3,2,3,0,5
"10607","10579429",0,4,4,7,3,14
"10608","10579434",0,2,1,0,0,1
"10609","10579442",0,1,0,1,0,1
"10610","10579460",0,2,0,0,0,0
"10611","10579495",0,2,0,0,0,0
"10612","10579547",0,1,0,0,0,0
"10613","10579553",0,2,0,0,0,0
"10614","10579556",0,2,0,0,0,0
"10615","10579583",0,2,1,0,0,1
"10616","10579585",0,1,0,0,0,0
"10617","10579605",0,1,0,0,0,0
"10618","10579610",0,2,0,0,0,0
"10619","10579614",0,2,1,0,0,1
"10620","10579618",0,1,0,0,0,0
"10621","10579621",0,2,0,0,1,1
"10622","10579624",0,3,1,5,0,6
"10623","10579628",0,3,2,2,0,4
"10624","10579630",0,2,0,0,0,0
"10625","10579636",0,1,0,0,0,0
"10626","10579661",0,1,0,0,0,0
"10627","10579679",0,3,7,3,0,10
"10628","10579695",0,2,0,2,0,2
"10629","10579719",0,1,1,1,0,2
"10630","10579792",0,2,2,0,0,2
"10631","10579811",0,3,2,1,1,4
"10632","10579825",0,3,3,1,0,4
"10633","10579831",0,2,1,2,0,3
"10634","10579835",0,3,5,7,0,12
"10635","10579865",0,2,0,0,0,0
"10636","10579880",0,1,0,0,0,0
"10637","10579883",0,3,2,4,0,6
"10638","10579888",0,2,1,0,0,1
"10639","10579889",0,2,0,0,0,0
"10640","10579899",1,2,0,1,0,1
"10641","10579900",0,3,1,5,1,7
"10642","10579948",1,2,0,0,0,0
"10643","10579978",0,2,0,0,0,0
"10644","10579979",0,2,0,0,0,0
"10645","10580014",0,2,1,0,0,1
"10646","10580015",0,2,2,2,0,4
"10647","10580068",0,2,2,1,0,3
"10648","10580069",0,3,3,4,1,8
"10649","10580090",0,1,0,0,0,0
"10650","10580091",0,2,2,1,0,3
"10651","10580152",0,2,0,4,0,4
"10652","10580155",0,2,2,0,0,2
"10653","10580178",0,3,2,3,0,5
"10654","10580203",0,2,2,0,0,2
"10655","10580211",0,2,0,0,0,0
"10656","10580253",1,2,0,1,0,1
"10657","10580265",0,2,0,0,0,0
"10658","10580268",0,2,0,1,0,1
"10659","10580297",0,2,0,0,0,0
"10660","10580346",0,2,0,0,0,0
"10661","10580365",0,2,1,0,0,1
"10662","10580380",0,1,0,0,0,0
"10663","10580405",0,1,0,0,0,0
"10664","10580407",0,2,0,0,0,0
"10665","10580413",0,2,0,0,0,0
"10666","10580415",0,2,0,3,0,3
"10667","10580419",0,1,0,0,0,0
"10668","10580435",0,2,0,0,0,0
"10669","10580440",0,3,0,1,0,1
"10670","10580443",0,2,1,2,0,3
"10671","10580446",0,2,1,0,0,1
"10672","10580465",0,2,0,0,0,0
"10673","10580480",0,2,0,0,0,0
"10674","10580509",0,1,0,0,0,0
"10675","10580511",0,2,1,0,0,1
"10676","10580518",0,2,0,4,0,4
"10677","10580519",0,2,1,0,0,1
"10678","10580539",0,2,1,0,0,1
"10679","10580548",0,2,0,0,0,0
"10680","10580549",0,1,0,0,0,0
"10681","10580598",0,1,0,0,0,0
"10682","10580612",0,2,0,1,1,2
"10683","10580732",0,2,5,2,0,7
"10684","10580757",0,2,0,0,0,0
"10685","10580804",0,1,0,0,0,0
"10686","10580875",0,2,0,0,0,0
"10687","10580882",0,2,0,1,0,1
"10688","10580900",0,2,0,0,0,0
"10689","10580902",0,2,0,0,0,0
"10690","10580907",0,2,0,0,0,0
"10691","10580933",0,1,0,0,0,0
"10692","10580941",0,2,0,0,0,0
"10693","10580950",0,1,0,0,0,0
"10694","10580964",0,2,0,0,0,0
"10695","10580976",0,1,0,0,0,0
"10696","10580996",0,2,0,0,0,0
"10697","10580998",0,2,0,2,0,2
"10698","10581001",0,2,2,0,0,2
"10699","10581006",0,2,0,0,0,0
"10700","10581010",0,2,1,1,0,2
"10701","10581012",0,2,0,0,0,0
"10702","10581023",0,2,0,0,0,0
"10703","10581039",0,2,0,1,0,1
"10704","10581076",0,2,2,2,0,4
"10705","10581084",0,3,0,3,0,3
"10706","10581110",0,2,0,0,0,0
"10707","10581128",0,1,0,0,0,0
"10708","10581134",0,1,0,0,0,0
"10709","10581138",0,2,0,0,0,0
"10710","10581141",0,2,0,0,0,0
"10711","10581166",0,2,0,0,0,0
"10712","10581218",0,1,1,0,0,1
"10713","10581226",0,2,1,4,0,5
"10714","10581228",0,3,2,9,1,12
"10715","10581252",0,2,1,5,0,6
"10716","10581256",0,2,0,4,0,4
"10717","10581258",0,1,0,0,0,0
"10718","10581281",0,2,0,2,0,2
"10719","10581330",0,3,2,2,0,4
"10720","10581350",0,2,0,0,0,0
"10721","10581354",0,2,0,0,0,0
"10722","10581356",0,2,0,1,0,1
"10723","10581364",0,2,0,0,0,0
"10724","10581365",0,2,0,0,0,0
"10725","10581436",0,2,2,2,0,4
"10726","10581454",0,1,0,0,0,0
"10727","10581466",0,2,3,0,0,3
"10728","10581484",0,2,0,0,0,0
"10729","10581507",0,2,1,0,0,1
"10730","10581551",0,2,1,2,0,3
"10731","10581562",0,2,1,0,0,1
"10732","10581579",0,2,3,0,0,3
"10733","10581603",0,2,1,0,0,1
"10734","10581605",0,2,0,0,0,0
"10735","10581614",0,2,0,0,0,0
"10736","10581616",0,3,0,0,0,0
"10737","10581628",0,2,0,1,0,1
"10738","10581648",0,2,0,0,0,0
"10739","10581665",0,2,4,5,0,9
"10740","10581667",0,2,1,0,0,1
"10741","10581670",0,3,3,5,1,9
"10742","10581674",0,2,5,4,0,9
"10743","10581701",1,2,1,1,0,2
"10744","10581707",0,1,0,0,0,0
"10745","10581714",0,2,0,2,0,2
"10746","10581761",0,2,0,1,0,1
"10747","10581763",0,2,0,1,0,1
"10748","10581764",0,2,1,1,0,2
"10749","10581766",0,3,3,1,0,4
"10750","10581797",0,2,1,1,0,2
"10751","10581802",0,1,0,0,0,0
"10752","10581804",0,2,1,0,0,1
"10753","10581807",0,2,2,0,0,2
"10754","10581809",0,1,0,0,0,0
"10755","10581811",0,1,0,0,0,0
"10756","10581814",0,1,0,0,0,0
"10757","10581815",0,1,0,0,0,0
"10758","10581821",0,2,0,1,0,1
"10759","10581915",1,3,0,0,0,0
"10760","10581958",0,2,1,0,0,1
"10761","10581961",0,2,1,2,0,3
"10762","10581963",0,2,3,2,0,5
"10763","10581978",0,2,4,3,0,7
"10764","10582005",0,2,0,1,0,1
"10765","10582032",0,2,3,6,0,9
"10766","10582058",0,2,2,0,0,2
"10767","10582061",0,3,3,2,0,5
"10768","10582063",0,2,2,2,0,4
"10769","10582101",0,2,0,0,0,0
"10770","10582194",0,2,2,0,0,2
"10771","10582204",0,5,0,8,1,9
"10772","10582229",0,3,0,4,0,4
"10773","10582238",1,2,1,0,0,1
"10774","10582245",0,2,2,1,0,3
"10775","10582247",0,2,0,0,0,0
"10776","10582248",0,4,4,6,0,10
"10777","10582256",0,1,0,0,0,0
"10778","10582311",0,2,0,0,0,0
"10779","10582315",0,3,4,3,1,8
"10780","10582326",0,1,0,0,0,0
"10781","10582327",0,2,2,0,0,2
"10782","10582329",0,2,1,1,0,2
"10783","10582365",0,1,0,0,0,0
"10784","10582366",0,2,3,0,0,3
"10785","10582373",0,3,2,2,0,4
"10786","10582378",0,2,0,0,0,0
"10787","10582400",0,2,1,0,0,1
"10788","10582443",0,2,0,0,0,0
"10789","10582447",0,1,0,0,0,0
"10790","10582449",0,2,2,1,0,3
"10791","10582466",0,2,0,0,0,0
"10792","10582504",0,2,0,0,0,0
"10793","10582535",0,2,0,0,0,0
"10794","10582552",0,2,0,0,0,0
"10795","10582578",0,4,2,5,4,11
"10796","10582594",0,3,3,0,0,3
"10797","10582614",0,3,0,0,0,0
"10798","10582617",0,3,5,3,0,8
"10799","10582626",0,3,1,10,0,11
"10800","10582648",0,2,0,0,0,0
"10801","10582667",0,1,2,0,0,2
"10802","10582734",0,2,0,0,0,0
"10803","10582749",0,2,0,0,0,0
"10804","10582750",0,1,0,0,0,0
"10805","10582753",0,2,0,0,0,0
"10806","10582754",0,2,0,2,0,2
"10807","10582755",0,2,1,1,0,2
"10808","10582772",0,2,0,1,0,1
"10809","10582776",0,1,0,0,0,0
"10810","10582792",0,2,0,1,0,1
"10811","10582825",0,2,0,0,0,0
"10812","10582835",0,2,0,1,0,1
"10813","10582868",0,2,1,2,0,3
"10814","10582875",0,1,0,2,0,2
"10815","10582877",0,2,0,0,0,0
"10816","10582898",0,2,1,3,0,4
"10817","10582906",0,2,0,0,0,0
"10818","10583009",0,2,0,0,0,0
"10819","10583024",0,2,0,0,0,0
"10820","10583035",0,3,3,1,1,5
"10821","10583097",0,2,0,0,0,0
"10822","10583101",0,2,2,1,0,3
"10823","10583117",0,2,0,0,0,0
"10824","10583164",0,2,0,2,0,2
"10825","10583185",0,2,0,0,0,0
"10826","10583194",0,2,4,3,0,7
"10827","10583199",0,2,2,0,0,2
"10828","10583205",0,1,0,0,0,0
"10829","10583208",0,2,1,0,0,1
"10830","10583211",0,2,0,0,0,0
"10831","10583221",0,2,2,0,0,2
"10832","10583230",0,2,1,0,0,1
"10833","10583232",0,1,0,0,0,0
"10834","10583359",0,2,0,3,0,3
"10835","10583442",0,1,0,0,0,0
"10836","10583446",0,2,0,2,0,2
"10837","10583500",0,1,1,1,0,2
"10838","10583524",0,1,1,1,0,2
"10839","10583566",0,2,3,1,0,4
"10840","10583587",0,1,0,0,0,0
"10841","10583591",0,2,1,0,0,1
"10842","10583595",0,3,1,2,0,3
"10843","10583651",0,1,0,1,0,1
"10844","10583726",0,2,1,1,0,2
"10845","10583727",0,2,0,0,0,0
"10846","10583733",0,2,2,1,1,4
"10847","10583791",0,1,0,0,0,0
"10848","10583853",0,1,0,0,0,0
"10849","10583890",0,1,0,0,0,0
"10850","10583894",0,1,0,0,0,0
"10851","10583923",1,1,0,0,0,0
"10852","10583948",0,1,0,0,0,0
"10853","10583950",0,1,0,0,0,0
"10854","10583960",0,1,0,3,0,3
"10855","10583987",0,1,1,1,0,2
"10856","10583988",0,3,1,2,0,3
"10857","10583989",0,2,0,0,0,0
"10858","10584001",1,1,0,0,0,0
"10859","10584011",0,1,0,0,0,0
"10860","10584013",0,2,1,3,0,4
"10861","10584018",0,1,1,0,0,1
"10862","10584023",0,1,0,0,0,0
"10863","10584044",0,1,0,0,0,0
"10864","10584064",0,1,0,0,0,0
"10865","10584089",0,2,1,0,0,1
"10866","10584091",0,1,0,0,0,0
"10867","10584093",1,1,0,0,0,0
"10868","10584147",1,1,1,1,0,2
"10869","10584148",1,1,0,0,0,0
"10870","10584149",1,1,0,0,0,0
"10871","10584192",0,1,0,0,0,0
"10872","10584209",0,1,1,3,0,4
"10873","10584224",0,1,0,0,0,0
"10874","10584231",0,1,0,0,0,0
"10875","10584238",0,2,0,1,0,1
"10876","10584240",0,1,0,0,0,0
"10877","10584253",0,2,1,1,0,2
"10878","10584254",0,1,0,0,0,0
"10879","10584261",0,1,1,1,0,2
"10880","10584270",0,2,1,3,0,4
"10881","10584286",0,2,2,0,0,2
"10882","10584299",0,1,0,0,0,0
"10883","10584303",0,1,0,0,0,0
"10884","10584329",0,1,0,0,0,0
"10885","10584332",0,2,1,5,0,6
"10886","10584366",0,1,0,0,0,0
"10887","10584381",0,1,2,0,0,2
"10888","10584388",0,1,0,0,0,0
"10889","10584438",0,1,0,0,0,0
"10890","10584445",0,1,0,0,0,0
"10891","10584470",0,1,3,0,0,3
"10892","10584549",0,2,1,4,0,5
"10893","10584561",0,2,2,1,0,3
"10894","10584636",0,1,0,3,0,3
"10895","10584647",0,1,3,1,0,4
"10896","10584656",0,1,0,0,0,0
"10897","10584657",0,1,0,1,0,1
"10898","10584661",0,1,0,0,0,0
"10899","10584662",0,1,0,2,0,2
"10900","10584666",0,1,0,3,0,3
"10901","10584690",0,2,1,2,1,4
"10902","10584700",0,1,0,0,0,0
"10903","10584701",0,1,0,0,0,0
"10904","10584725",0,1,0,0,0,0
"10905","10584780",0,1,2,3,0,5
"10906","10584806",0,1,0,0,0,0
"10907","10584846",0,1,2,4,0,6
"10908","10584853",0,3,3,4,0,7
"10909","10584856",0,1,1,1,0,2
"10910","10584868",0,2,3,3,0,6
"10911","10584871",0,2,0,0,0,0
"10912","10584876",0,1,0,0,0,0
"10913","10584878",1,1,0,0,0,0
"10914","10584903",0,1,0,3,0,3
"10915","10584914",0,1,1,0,0,1
"10916","10584920",0,1,0,0,0,0
"10917","10584924",0,4,3,5,2,10
"10918","10584927",0,1,0,0,0,0
"10919","10584929",0,1,0,0,0,0
"10920","10584938",0,1,0,1,0,1
"10921","10584965",0,1,0,0,0,0
"10922","10584970",0,2,1,0,0,1
"10923","10585011",0,1,0,0,0,0
"10924","10585012",0,1,0,0,0,0
"10925","10585016",0,1,0,0,0,0
"10926","10585017",0,1,1,0,0,1
"10927","10585040",0,1,0,0,0,0
"10928","10585044",0,1,0,0,0,0
"10929","10585086",0,2,1,1,0,2
"10930","10585087",0,1,0,2,0,2
"10931","10585091",0,3,0,0,1,1
"10932","10585094",0,1,0,0,0,0
"10933","10585100",0,1,1,0,0,1
"10934","10585101",0,2,0,0,0,0
"10935","10585133",0,1,1,0,0,1
"10936","10585138",0,1,0,1,0,1
"10937","10585140",0,1,1,2,0,3
"10938","10585196",0,2,1,0,0,1
"10939","10585227",0,1,0,0,0,0
"10940","10585252",0,1,0,3,0,3
"10941","10585262",0,2,3,1,0,4
"10942","10585290",0,1,0,1,0,1
"10943","10585291",0,1,0,0,0,0
"10944","10585315",0,1,0,0,0,0
"10945","10585323",0,1,1,0,0,1
"10946","10585324",0,1,3,0,0,3
"10947","10585356",0,2,0,1,0,1
"10948","10585357",0,1,0,0,0,0
"10949","10585371",0,1,0,0,0,0
"10950","10585377",0,1,0,0,0,0
"10951","10585388",0,1,1,0,0,1
"10952","10585395",1,1,0,0,0,0
"10953","10585396",0,1,0,0,0,0
"10954","10585414",0,2,0,3,0,3
"10955","10585420",0,1,0,0,0,0
"10956","10585423",0,1,0,0,0,0
"10957","10585427",0,2,5,1,0,6
"10958","10585430",0,1,1,1,0,2
"10959","10585432",0,1,0,0,0,0
"10960","10585435",0,2,3,3,0,6
"10961","10585453",0,1,0,0,0,0
"10962","10585465",0,1,1,3,0,4
"10963","10585469",0,1,0,0,0,0
"10964","10585519",0,2,0,2,0,2
"10965","10585559",0,1,0,2,0,2
"10966","10585560",0,1,1,0,0,1
"10967","10585665",1,1,0,3,0,3
"10968","10585669",0,1,0,0,0,0
"10969","10585687",0,2,1,3,2,6
"10970","10585695",0,2,0,3,0,3
"10971","10585753",0,1,0,0,0,0
"10972","10585760",0,1,0,0,0,0
"10973","10585765",0,1,0,1,0,1
"10974","10585766",0,1,0,0,0,0
"10975","10585772",0,2,3,1,0,4
"10976","10585781",0,1,1,1,0,2
"10977","10585792",0,1,0,1,0,1
"10978","10585797",0,4,4,7,0,11
"10979","10585821",0,2,0,6,0,6
"10980","10585827",0,1,0,0,0,0
"10981","10585829",0,1,0,1,0,1
"10982","10585833",0,1,0,0,0,0
"10983","10585867",0,1,0,0,0,0
"10984","10585913",0,2,1,1,0,2
"10985","10585915",0,1,0,0,0,0
"10986","10585921",0,1,0,0,0,0
"10987","10585922",0,1,0,0,0,0
"10988","10585924",0,2,0,0,0,0
"10989","10585927",0,2,0,3,0,3
"10990","10585953",0,1,1,0,0,1
"10991","10585956",0,1,0,0,0,0
"10992","10586009",0,1,0,0,0,0
"10993","10586017",0,1,0,0,0,0
"10994","10586020",0,1,0,0,0,0
"10995","10586021",0,1,0,0,0,0
"10996","10586025",0,1,0,0,0,0
"10997","10586031",0,1,0,0,0,0
"10998","10586040",0,2,0,1,0,1
"10999","10586042",0,1,0,0,0,0
"11000","10586049",0,1,0,0,0,0
"11001","10586053",0,1,0,0,0,0
"11002","10586055",0,1,0,1,0,1
"11003","10586061",0,1,0,2,0,2
"11004","10586067",0,1,1,0,0,1
"11005","10586071",0,1,0,0,0,0
"11006","10586080",0,1,0,0,0,0
"11007","10586090",0,1,0,0,0,0
"11008","10586115",0,1,0,0,0,0
"11009","10586154",0,1,0,0,0,0
"11010","10586172",0,3,1,6,0,7
"11011","10586175",0,2,0,2,0,2
"11012","10586252",0,2,1,3,0,4
"11013","10586258",0,1,0,0,0,0
"11014","10586278",0,1,0,0,0,0
"11015","10586284",0,1,0,0,0,0
"11016","10586286",1,2,0,0,0,0
"11017","10586291",0,1,0,0,0,0
"11018","10586303",0,1,0,2,0,2
"11019","10586309",0,1,0,0,0,0
"11020","10586311",0,2,0,1,0,1
"11021","10586323",0,1,0,0,0,0
"11022","10586330",0,1,0,0,0,0
"11023","10586339",0,1,1,1,0,2
"11024","10586340",0,1,1,0,0,1
"11025","10586350",0,1,0,0,0,0
"11026","10586355",0,1,0,1,0,1
"11027","10586368",0,1,0,0,0,0
"11028","10586381",0,1,0,2,0,2
"11029","10586388",0,2,0,1,0,1
"11030","10586398",0,1,0,1,0,1
"11031","10586404",0,1,0,0,0,0
"11032","10586420",0,1,0,0,0,0
"11033","10586424",0,2,1,1,0,2
"11034","10586427",0,1,0,0,0,0
"11035","10586467",0,1,0,0,0,0
"11036","10586514",0,1,0,0,0,0
"11037","10586516",0,1,0,0,0,0
"11038","10586533",0,1,0,0,0,0
"11039","10586544",0,1,1,0,0,1
"11040","10586549",0,1,0,0,0,0
"11041","10586613",0,1,0,0,0,0
"11042","10586615",0,1,0,0,0,0
"11043","10586618",0,2,0,0,0,0
"11044","10586621",0,1,0,0,0,0
"11045","10586626",0,1,0,4,0,4
"11046","10586630",0,1,0,0,0,0
"11047","10586631",0,1,0,0,0,0
"11048","10586633",0,1,0,0,0,0
"11049","10586649",0,2,2,0,0,2
"11050","10586666",0,1,1,1,0,2
"11051","10586689",1,2,2,1,0,3
"11052","10586691",0,1,1,2,0,3
"11053","10586701",0,2,0,0,0,0
"11054","10586710",0,1,1,1,0,2
"11055","10586721",0,1,0,0,0,0
"11056","10586723",0,1,0,0,0,0
"11057","10586738",0,1,0,0,0,0
"11058","10586744",0,1,0,0,0,0
"11059","10586747",0,1,0,0,0,0
"11060","10586748",0,1,0,0,0,0
"11061","10586753",0,1,1,0,0,1
"11062","10586784",0,1,0,0,0,0
"11063","10586803",0,1,1,1,0,2
"11064","10586813",0,2,0,0,0,0
"11065","10586818",0,1,0,0,0,0
"11066","10586822",0,2,1,0,0,1
"11067","10586826",0,2,5,0,0,5
"11068","10586834",0,2,0,3,0,3
"11069","10586836",0,1,0,0,0,0
"11070","10586839",0,1,0,0,0,0
"11071","10586841",1,1,0,1,0,1
"11072","10586847",0,2,1,0,0,1
"11073","10586857",0,1,0,0,0,0
"11074","10586902",0,1,0,0,0,0
"11075","10586933",0,1,1,0,0,1
"11076","10586941",0,1,1,2,0,3
"11077","10586942",0,1,0,0,0,0
"11078","10586943",0,1,1,1,0,2
"11079","10586947",0,1,0,0,0,0
"11080","10586950",0,3,5,2,0,7
"11081","10586957",0,1,2,0,0,2
"11082","10587002",0,1,0,0,0,0
"11083","10587036",0,1,0,2,0,2
"11084","10587050",0,1,0,0,0,0
"11085","10587054",0,1,0,0,0,0
"11086","10587059",0,1,1,2,0,3
"11087","10587066",0,2,0,3,0,3
"11088","10587067",0,1,1,0,0,1
"11089","10587068",0,1,2,3,0,5
"11090","10587082",0,1,2,0,0,2
"11091","10587086",0,2,2,3,0,5
"11092","10587092",0,1,1,0,0,1
"11093","10587095",0,2,1,3,0,4
"11094","10587102",0,2,2,0,0,2
"11095","10587103",0,1,0,0,0,0
"11096","10587126",0,1,0,0,0,0
"11097","10587131",0,1,0,0,0,0
"11098","10587135",0,1,3,0,0,3
"11099","10587146",0,1,2,0,0,2
"11100","10587149",0,1,0,0,0,0
"11101","10587152",0,1,0,0,0,0
"11102","10587155",0,1,0,0,0,0
"11103","10587158",0,1,0,0,0,0
"11104","10587162",0,1,1,2,0,3
"11105","10587194",0,1,0,0,0,0
"11106","10587196",0,1,1,0,0,1
"11107","10587220",0,1,0,1,0,1
"11108","10587234",0,1,0,0,0,0
"11109","10587239",0,1,0,0,0,0
"11110","10587247",0,1,0,0,0,0
"11111","10587250",0,1,0,0,0,0
"11112","10587266",0,1,1,4,0,5
"11113","10587270",0,1,0,0,0,0
"11114","10587301",0,1,0,0,0,0
"11115","10587390",0,1,0,0,0,0
"11116","10587401",0,1,0,0,0,0
"11117","10587457",0,2,3,5,1,9
"11118","10587496",0,1,0,0,0,0
"11119","10587510",0,1,0,0,0,0
"11120","10587511",0,1,0,4,0,4
"11121","10587533",0,1,1,0,0,1
"11122","10587545",0,1,0,0,0,0
"11123","10587558",0,1,0,0,0,0
"11124","10587559",0,1,0,0,0,0
"11125","10587572",0,1,0,0,0,0
"11126","10587575",0,2,1,6,1,8
"11127","10587596",0,1,0,0,0,0
"11128","10587612",0,1,0,0,0,0
"11129","10587617",0,1,0,0,0,0
"11130","10587645",1,1,0,0,0,0
"11131","10587648",0,1,1,0,0,1
"11132","10587651",0,1,0,0,0,0
"11133","10587657",0,1,0,0,0,0
"11134","10587669",0,1,1,1,0,2
"11135","10587670",0,1,1,1,0,2
"11136","10587689",0,1,0,0,0,0
"11137","10587697",0,1,0,0,0,0
"11138","10587698",0,2,1,3,0,4
"11139","10587706",0,1,3,0,0,3
"11140","10587710",0,1,0,0,0,0
"11141","10587712",0,1,1,0,0,1
"11142","10587721",0,1,1,0,0,1
"11143","10587723",0,1,1,1,0,2
"11144","10587743",0,2,2,0,0,2
"11145","10587750",0,1,0,1,0,1
"11146","10587759",0,1,0,0,0,0
"11147","10587766",0,3,1,6,1,8
"11148","10587768",0,1,0,1,0,1
"11149","10587771",0,1,0,0,0,0
"11150","10587774",0,1,0,0,0,0
"11151","10587783",0,1,1,0,0,1
"11152","10587800",0,1,0,0,0,0
"11153","10587818",0,1,0,0,0,0
"11154","10587840",0,1,1,1,0,2
"11155","10587884",0,1,1,2,0,3
"11156","10587933",0,1,0,0,0,0
"11157","10587937",0,1,0,0,0,0
"11158","10587953",0,1,0,0,0,0
"11159","10587959",0,1,0,0,0,0
"11160","10588001",0,2,2,1,0,3
"11161","10588005",0,1,0,0,0,0
"11162","10588053",0,1,0,0,0,0
"11163","10588085",0,1,1,0,0,1
"11164","10588109",0,1,2,1,0,3
"11165","10588116",0,1,0,0,0,0
"11166","10588132",1,1,0,0,0,0
"11167","10588183",0,3,4,3,0,7
"11168","10588185",0,1,0,1,0,1
"11169","10588191",0,1,0,0,0,0
"11170","10588192",0,1,0,0,0,0
"11171","10588196",0,1,0,2,0,2
"11172","10588217",0,1,1,2,0,3
"11173","10588218",0,1,0,0,0,0
"11174","10588228",0,1,0,0,0,0
"11175","10588229",0,1,0,0,0,0
"11176","10588254",0,1,0,0,0,0
"11177","10588269",0,1,0,0,0,0
"11178","10588280",0,2,0,0,0,0
"11179","10588298",0,2,4,4,2,10
"11180","10588324",0,1,0,0,0,0
"11181","10588326",0,2,1,1,0,2
"11182","10588330",0,1,0,0,0,0
"11183","10588363",0,1,0,0,0,0
"11184","10588391",0,1,0,0,0,0
"11185","10588395",0,1,0,0,0,0
"11186","10588398",0,1,0,0,0,0
"11187","10588427",0,1,0,0,0,0
"11188","10588437",0,1,0,0,0,0
"11189","10588483",0,3,12,2,0,14
"11190","10588503",0,1,1,1,0,2
"11191","10588507",0,1,0,2,0,2
"11192","10588519",0,1,1,0,0,1
"11193","10588539",0,1,2,1,0,3
"11194","10588595",0,1,4,0,0,4
"11195","10588598",0,3,2,5,2,9
"11196","10588599",0,1,0,0,0,0
"11197","10588604",0,2,0,0,0,0
"11198","10588608",0,1,2,0,0,2
"11199","10588612",0,1,0,0,0,0
"11200","10588614",0,1,1,0,0,1
"11201","10588627",0,1,0,3,0,3
"11202","10588637",0,1,0,0,0,0
"11203","10588665",0,1,0,0,0,0
"11204","10588668",0,1,0,0,0,0
"11205","10588689",0,1,1,0,0,1
"11206","10588702",0,1,0,3,0,3
"11207","10588710",0,1,0,0,0,0
"11208","10588711",0,1,0,0,0,0
"11209","10588718",0,2,0,0,0,0
"11210","10588721",0,1,0,0,0,0
"11211","10588722",0,2,0,4,0,4
"11212","10588723",0,1,2,0,0,2
"11213","10588724",0,1,0,0,0,0
"11214","10588730",0,1,0,0,0,0
"11215","10588734",0,1,3,1,0,4
"11216","10588740",0,1,0,0,0,0
"11217","10588741",0,1,2,1,0,3
"11218","10588784",0,1,0,1,0,1
"11219","10588796",0,1,1,0,0,1
"11220","10588801",0,1,0,0,0,0
"11221","10588802",1,1,0,0,0,0
"11222","10588808",0,2,1,1,0,2
"11223","10588811",0,2,2,0,0,2
"11224","10588814",0,1,0,0,0,0
"11225","10588821",0,1,2,0,0,2
"11226","10588823",0,1,0,0,0,0
"11227","10588824",0,1,0,0,0,0
"11228","10588829",0,1,0,2,0,2
"11229","10588832",0,2,1,1,1,3
"11230","10588840",0,1,2,1,0,3
"11231","10588879",0,2,0,3,0,3
"11232","10588897",0,1,0,3,0,3
"11233","10588917",0,1,0,0,0,0
"11234","10588928",0,1,0,0,0,0
"11235","10588931",0,1,0,0,0,0
"11236","10588940",0,1,0,0,0,0
"11237","10588944",0,2,2,1,0,3
"11238","10588973",0,1,0,0,0,0
"11239","10588998",0,2,4,4,3,11
"11240","10589044",0,1,0,0,0,0
"11241","10589064",0,1,0,0,0,0
"11242","10589089",0,1,0,0,0,0
"11243","10589102",0,2,0,4,0,4
"11244","10589111",0,1,0,2,0,2
"11245","10589135",0,1,0,0,0,0
"11246","10589141",0,1,0,0,0,0
"11247","10589143",0,1,0,0,0,0
"11248","10589147",0,1,0,1,0,1
"11249","10589182",0,2,5,2,0,7
"11250","10589191",0,1,0,0,0,0
"11251","10589214",0,1,0,0,0,0
"11252","10589227",0,1,1,0,0,1
"11253","10589229",0,2,0,1,0,1
"11254","10589235",0,1,0,0,0,0
"11255","10589239",0,1,0,0,0,0
"11256","10589258",0,2,0,0,0,0
"11257","10589307",0,1,0,0,0,0
"11258","10589378",0,2,5,4,0,9
"11259","10589387",0,1,0,0,0,0
"11260","10589465",0,1,0,3,0,3
"11261","10589475",0,2,2,2,1,5
"11262","10589476",0,2,0,0,0,0
"11263","10589477",0,3,2,2,1,5
"11264","10589485",0,1,0,0,0,0
"11265","10589495",0,1,0,0,0,0
"11266","10589513",0,2,0,1,0,1
"11267","10589521",0,1,0,0,0,0
"11268","10589528",0,2,1,0,1,2
"11269","10589529",0,1,0,1,0,1
"11270","10589531",0,2,1,3,0,4
"11271","10589536",0,1,0,0,0,0
"11272","10589561",0,1,0,0,0,0
"11273","10589566",0,1,0,2,0,2
"11274","10589687",0,1,0,0,0,0
"11275","10589691",0,1,0,0,0,0
"11276","10589723",0,1,2,1,0,3
"11277","10589762",0,2,0,0,0,0
"11278","10589774",0,3,0,0,0,0
"11279","10589830",0,1,1,3,0,4
"11280","10589862",0,1,0,0,0,0
"11281","10589877",0,1,0,0,0,0
"11282","10589924",0,1,0,1,0,1
"11283","10589925",0,1,2,2,0,4
"11284","10589926",0,1,0,0,0,0
"11285","10589964",0,1,0,0,0,0
"11286","10589966",1,2,0,0,0,0
"11287","10589967",0,1,0,0,0,0
"11288","10590015",0,1,0,0,0,0
"11289","10590058",0,1,0,0,0,0
"11290","10590067",0,1,0,0,0,0
"11291","10590070",0,2,2,2,0,4
"11292","10590071",0,2,0,4,2,6
"11293","10590073",0,1,0,0,0,0
"11294","10590074",0,1,1,2,1,4
"11295","10590079",0,1,0,1,0,1
"11296","10590080",0,1,3,2,0,5
"11297","10590096",0,1,0,0,0,0
"11298","10590114",0,1,1,0,0,1
"11299","10590119",0,1,1,0,0,1
"11300","10590134",0,1,0,1,0,1
"11301","10590136",0,1,0,0,0,0
"11302","10590140",0,1,0,0,0,0
"11303","10590156",0,4,4,6,1,11
"11304","10590158",0,1,0,0,0,0
"11305","10590187",0,1,0,1,0,1
"11306","10590211",0,1,1,1,0,2
"11307","10590221",0,1,0,0,0,0
"11308","10590231",0,1,3,1,0,4
"11309","10590340",0,1,0,0,0,0
"11310","10590350",0,1,0,0,0,0
"11311","10590371",0,1,2,0,0,2
"11312","10590389",0,1,0,2,0,2
"11313","10590432",0,1,0,0,0,0
"11314","10590451",0,1,0,0,0,0
"11315","10590458",0,1,0,1,0,1
"11316","10590507",0,1,0,0,0,0
"11317","10590520",0,2,0,0,0,0
"11318","10590531",0,1,0,0,0,0
"11319","10590544",0,2,1,1,0,2
"11320","10590546",0,1,0,0,0,0
"11321","10590559",0,1,1,0,0,1
"11322","10590567",0,1,0,0,0,0
"11323","10590583",0,1,1,0,0,1
"11324","10590586",0,1,0,0,0,0
"11325","10590589",0,1,1,1,0,2
"11326","10590590",0,1,0,0,0,0
"11327","10590602",0,1,0,0,0,0
"11328","10590609",0,1,0,1,0,1
"11329","10590641",0,1,0,0,0,0
"11330","10590642",0,1,0,0,0,0
"11331","10590662",0,2,0,1,0,1
"11332","10590934",0,1,0,0,0,0
"11333","10591223",0,1,0,0,0,0
"11334","10591227",0,1,1,0,0,1
"11335","10591240",0,1,1,0,0,1
"11336","10591248",0,1,0,0,0,0
"11337","10591249",0,1,1,3,0,4
"11338","10591251",0,1,1,0,0,1
"11339","10591264",0,1,0,0,0,0
"11340","10591266",0,1,0,0,0,0
"11341","10591282",0,1,0,0,0,0
"11342","10591308",0,2,0,1,1,2
"11343","10591313",0,1,0,0,0,0
"11344","10591318",0,1,0,0,0,0
"11345","10591321",0,1,0,0,0,0
"11346","10591347",0,1,0,0,0,0
"11347","10591369",0,2,1,2,1,4
"11348","10591390",0,1,2,1,0,3
"11349","10591397",0,1,2,4,0,6
"11350","10591408",0,1,0,0,0,0
"11351","10591433",0,1,0,0,0,0
"11352","10591435",0,1,0,0,0,0
"11353","10591436",0,1,0,0,0,0
"11354","10591437",0,1,0,0,0,0
"11355","10591442",0,1,0,0,0,0
"11356","10591454",0,1,0,0,0,0
"11357","10591470",0,1,0,0,0,0
"11358","10591479",0,1,0,0,0,0
"11359","10591506",0,1,0,1,0,1
"11360","10591512",0,1,3,0,0,3
"11361","10591515",0,1,3,2,0,5
"11362","10591516",0,1,0,0,0,0
"11363","10591519",0,1,1,0,0,1
"11364","10591528",0,1,0,0,0,0
"11365","10591530",0,2,4,3,0,7
"11366","10591533",0,1,0,0,0,0
"11367","10591539",0,1,1,1,0,2
"11368","10591561",0,3,4,4,0,8
"11369","10591583",0,1,0,0,0,0
"11370","10591594",0,2,1,2,0,3
"11371","10591600",1,1,0,0,0,0
"11372","10591601",0,1,1,1,0,2
"11373","10591607",0,1,0,0,0,0
"11374","10591609",0,2,3,8,2,13
"11375","10591611",0,1,0,0,0,0
"11376","10591647",0,1,0,0,0,0
"11377","10591663",0,1,0,0,0,0
"11378","10591665",0,1,0,0,0,0
"11379","10591721",0,1,0,0,0,0
"11380","10591724",0,1,0,0,0,0
"11381","10591727",0,1,0,0,0,0
"11382","10591769",0,1,0,0,0,0
"11383","10591787",0,1,0,0,0,0
"11384","10591788",0,2,1,0,0,1
"11385","10591798",0,1,0,0,0,0
"11386","10591804",0,1,2,0,0,2
"11387","10591823",0,1,2,3,0,5
"11388","10591829",0,2,2,5,1,8
"11389","10591850",0,1,0,0,0,0
"11390","10591897",0,1,1,2,0,3
"11391","10591904",0,2,0,0,0,0
"11392","10591908",0,1,0,0,0,0
"11393","10591910",0,1,0,0,0,0
"11394","10591928",0,2,0,0,0,0
"11395","10591934",0,1,0,0,0,0
"11396","10591940",0,1,0,0,0,0
"11397","10591961",0,1,2,1,0,3
"11398","10591966",0,1,0,0,0,0
"11399","10591996",0,1,0,0,0,0
"11400","10592041",0,1,0,0,0,0
"11401","10592042",0,1,0,0,0,0
"11402","10592065",0,1,1,0,0,1
"11403","10592082",0,1,1,0,0,1
"11404","10592086",0,1,0,0,0,0
"11405","10592094",0,1,1,3,0,4
"11406","10592104",0,1,0,0,0,0
"11407","10592107",0,2,0,1,0,1
"11408","10592108",0,2,0,0,0,0
"11409","10592141",0,1,0,0,0,0
"11410","10592152",0,1,0,0,0,0
"11411","10592162",0,1,0,2,0,2
"11412","10592208",0,1,0,0,0,0
"11413","10592228",1,1,0,0,0,0
"11414","10592235",0,2,1,3,0,4
"11415","10592266",0,1,0,0,0,0
"11416","10592407",0,1,2,0,0,2
"11417","10592415",0,2,0,1,0,1
"11418","10592459",0,1,0,0,0,0
"11419","10592461",0,1,0,1,0,1
"11420","10592475",0,1,0,2,0,2
"11421","10592479",0,1,0,0,0,0
"11422","10592501",0,1,0,0,0,0
"11423","10592508",0,1,2,2,0,4
"11424","10592580",0,1,3,0,0,3
"11425","10592604",0,1,0,0,0,0
"11426","10592607",0,1,2,0,0,2
"11427","10592609",0,1,0,0,0,0
"11428","10592630",0,1,0,0,0,0
"11429","10592663",0,2,1,3,0,4
"11430","10592690",0,1,2,0,0,2
"11431","10592717",0,1,1,5,0,6
"11432","10592737",0,1,0,0,0,0
"11433","10592738",0,1,0,0,0,0
"11434","10592741",0,1,0,0,0,0
"11435","10592747",0,1,0,0,0,0
"11436","10592770",0,1,2,0,0,2
"11437","10592771",0,1,0,0,0,0
"11438","10592772",0,1,0,0,0,0
"11439","10592788",0,3,5,6,0,11
"11440","10592793",0,1,0,0,0,0
"11441","10592795",0,1,1,0,0,1
"11442","10592805",0,2,2,3,1,6
"11443","10592835",0,1,1,0,0,1
"11444","10592838",0,1,0,0,0,0
"11445","10592842",0,1,0,0,0,0
"11446","10592843",0,1,0,0,0,0
"11447","10592870",0,1,0,0,0,0
"11448","10592880",0,1,0,0,0,0
"11449","10592892",0,1,0,2,0,2
"11450","10593027",0,1,1,3,0,4
"11451","10593044",0,1,0,0,0,0
"11452","10593051",0,1,0,0,0,0
"11453","10593056",0,1,0,0,0,0
"11454","10593072",0,1,0,0,0,0
"11455","10593092",0,1,0,0,0,0
"11456","10593096",0,1,0,0,0,0
"11457","10593104",0,1,0,0,0,0
"11458","10593124",0,1,0,0,0,0
"11459","10593126",0,1,1,1,0,2
"11460","10593129",0,1,0,0,0,0
"11461","10593134",0,1,0,0,0,0
"11462","10593153",0,2,1,0,0,1
"11463","10593157",0,1,0,0,0,0
"11464","10593164",0,1,0,0,0,0
"11465","10593209",0,2,1,3,1,5
"11466","10593216",0,1,0,2,0,2
"11467","10593224",0,1,0,0,0,0
"11468","10593227",0,1,0,2,0,2
"11469","10593234",0,1,2,2,0,4
"11470","10593237",0,2,4,4,1,9
"11471","10593242",0,1,0,0,0,0
"11472","10593254",0,1,0,0,0,0
"11473","10593256",0,1,0,0,0,0
"11474","10593265",0,1,0,0,0,0
"11475","10593279",0,1,0,0,0,0
"11476","10593282",0,1,0,1,0,1
"11477","10593319",0,1,0,0,0,0
"11478","10593322",0,1,1,1,0,2
"11479","10593359",0,1,1,0,0,1
"11480","10593371",0,1,0,0,0,0
"11481","10593378",0,1,0,0,0,0
"11482","10593385",0,1,0,1,0,1
"11483","10593402",0,2,1,1,0,2
"11484","10593421",0,1,0,0,0,0
"11485","10593424",0,2,0,3,1,4
"11486","10593425",0,1,0,0,0,0
"11487","10593441",0,1,0,0,0,0
"11488","10593449",0,1,0,0,0,0
"11489","10593455",0,1,0,0,0,0
"11490","10593499",0,1,0,0,0,0
"11491","10593520",0,1,0,0,0,0
"11492","10593521",0,2,1,3,0,4
"11493","10593532",0,1,0,0,0,0
"11494","10593568",0,1,0,0,0,0
"11495","10593613",0,1,0,1,0,1
"11496","10593662",0,1,0,0,0,0
"11497","10593694",0,1,0,0,0,0
"11498","10593695",0,1,0,0,0,0
"11499","10593712",0,1,0,0,0,0
"11500","10593724",0,1,0,0,0,0
"11501","10593727",0,1,0,0,0,0
"11502","10593742",0,1,0,0,0,0
"11503","10593743",0,1,0,0,0,0
"11504","10593794",0,1,1,0,0,1
"11505","10593828",1,1,0,0,0,0
"11506","10593868",0,2,3,3,0,6
"11507","10593905",0,1,2,0,0,2
"11508","10593938",0,1,0,0,0,0
"11509","10593941",0,1,0,0,0,0
"11510","10593954",0,1,0,0,0,0
"11511","10593955",0,1,1,5,0,6
"11512","10593988",0,1,1,0,0,1
"11513","10593993",0,1,1,2,0,3
"11514","10593994",0,1,0,0,0,0
"11515","10593996",0,1,0,0,0,0
"11516","10594034",0,1,0,0,0,0
"11517","10594054",0,1,0,0,0,0
"11518","10594109",0,1,0,0,0,0
"11519","10594119",0,1,0,0,0,0
"11520","10594125",0,1,0,0,0,0
"11521","10594143",0,1,0,0,0,0
"11522","10594152",0,1,0,0,0,0
"11523","10594159",0,2,0,0,0,0
"11524","10594168",0,1,0,1,0,1
"11525","10594172",0,1,0,0,0,0
"11526","10594184",0,1,3,0,0,3
"11527","10594195",0,1,0,0,0,0
"11528","10594201",0,1,0,0,0,0
"11529","10594229",0,1,0,0,0,0
"11530","10594230",0,1,1,0,0,1
"11531","10594273",0,2,2,5,0,7
"11532","10594300",0,2,0,4,1,5
"11533","10594328",0,1,0,0,0,0
"11534","10594385",0,1,0,1,0,1
"11535","10594411",0,1,0,0,0,0
"11536","10594439",0,1,1,1,0,2
"11537","10594440",0,1,4,2,0,6
"11538","10594453",0,1,0,0,0,0
"11539","10594481",0,1,0,0,0,0
"11540","10594552",0,2,2,0,0,2
"11541","10594555",0,1,0,0,0,0
"11542","10594567",0,1,1,0,0,1
"11543","10594571",0,1,1,4,0,5
"11544","10594588",0,1,0,1,0,1
"11545","10594594",0,1,0,0,0,0
"11546","10594620",0,1,0,0,0,0
"11547","10594627",0,1,0,0,0,0
"11548","10594631",0,1,1,0,0,1
"11549","10594633",0,1,0,0,0,0
"11550","10594663",0,1,0,0,0,0
"11551","10594722",0,1,2,0,0,2
"11552","10594724",0,1,1,0,0,1
"11553","10594759",0,1,0,0,0,0
"11554","10594768",0,1,0,0,0,0
"11555","10594770",0,1,1,0,0,1
"11556","10594783",0,1,0,0,0,0
"11557","10594784",0,1,0,1,0,1
"11558","10594794",0,1,0,0,0,0
"11559","10594840",0,1,0,0,0,0
"11560","10594842",0,1,0,2,0,2
"11561","10594843",0,1,0,0,0,0
"11562","10594846",0,1,0,0,0,0
"11563","10594910",0,1,0,0,0,0
"11564","10594913",0,1,1,2,0,3
"11565","10594915",0,1,0,2,0,2
"11566","10594916",0,1,0,0,0,0
"11567","10594920",0,1,1,1,0,2
"11568","10594923",0,1,0,0,0,0
"11569","10594924",0,1,0,0,0,0
"11570","10594942",0,1,0,0,0,0
"11571","10594965",0,2,2,2,1,5
"11572","10594976",0,1,2,1,0,3
"11573","10594986",0,1,0,0,0,0
"11574","10595168",0,1,0,0,0,0
"11575","10595222",0,1,0,0,0,0
"11576","10595225",0,1,3,0,0,3
"11577","10595240",0,1,0,0,0,0
"11578","10595253",0,1,0,1,0,1
"11579","10595254",0,1,1,1,0,2
"11580","10595256",0,1,0,0,0,0
"11581","10595260",0,1,0,0,0,0
"11582","10595270",0,1,0,1,0,1
"11583","10595273",0,1,0,0,0,0
"11584","10595278",0,1,0,0,0,0
"11585","10595295",0,1,0,0,0,0
"11586","10595315",0,1,0,0,0,0
"11587","10595320",0,1,0,0,0,0
"11588","10595348",0,1,1,1,0,2
"11589","10595387",0,1,0,0,0,0
"11590","10595395",0,1,0,0,0,0
"11591","10595400",0,1,0,0,0,0
"11592","10595451",0,1,0,0,0,0
"11593","10595455",0,1,0,0,0,0
"11594","10595456",0,1,0,0,0,0
"11595","10595462",0,1,0,1,0,1
"11596","10595487",1,1,1,1,0,2
"11597","10595492",0,1,0,0,0,0
"11598","10595510",0,2,1,3,1,5
"11599","10595513",0,1,1,0,0,1
"11600","10595589",0,2,3,2,0,5
"11601","10595620",0,1,0,0,0,0
"11602","10595628",0,2,0,4,0,4
"11603","10595657",0,1,0,0,0,0
"11604","10595675",0,1,0,0,0,0
"11605","10595679",0,1,0,0,0,0
"11606","10595681",0,1,1,1,0,2
"11607","10595749",0,1,0,0,0,0
"11608","10595752",0,1,0,0,0,0
"11609","10595780",0,1,1,0,0,1
"11610","10595781",0,1,0,0,0,0
"11611","10595811",0,1,0,0,0,0
"11612","10595917",0,1,0,0,0,0
"11613","10595927",0,1,0,0,0,0
"11614","10595991",0,2,2,2,1,5
"11615","10596038",0,1,0,0,0,0
"11616","10596039",0,1,0,0,0,0
"11617","10596092",0,1,0,0,0,0
"11618","10596100",0,1,0,0,0,0
"11619","10596114",0,1,0,0,0,0
"11620","10596130",0,1,0,0,0,0
"11621","10596163",0,2,3,5,0,8
"11622","10596186",0,1,2,0,0,2
"11623","10596312",0,2,0,1,0,1
"11624","10596313",0,2,2,7,2,11
"11625","10596315",0,2,1,4,2,7
"11626","10596336",0,1,0,0,0,0
"11627","10596450",0,1,0,0,0,0
"11628","10596453",0,1,1,3,0,4
"11629","10596471",0,1,2,0,0,2
"11630","10596473",0,1,0,0,0,0
"11631","10596474",0,1,0,0,0,0
"11632","10596475",0,1,0,0,0,0
"11633","10596515",0,1,0,0,0,0
"11634","10596574",0,1,1,2,0,3
"11635","10596673",0,1,0,0,0,0
"11636","10596706",0,1,0,0,0,0
"11637","10596740",0,1,0,3,1,4
"11638","10596778",0,2,3,1,0,4
"11639","10596781",0,1,2,0,0,2
"11640","10596789",0,1,0,0,0,0
"11641","10596794",0,1,1,0,0,1
"11642","10596809",0,1,0,0,0,0
"11643","10596812",0,1,0,0,0,0
"11644","10596818",0,1,0,0,0,0
"11645","10596823",0,1,0,0,0,0
"11646","10596830",0,1,0,0,0,0
"11647","10596831",0,1,0,0,0,0
"11648","10596860",0,1,0,2,0,2
"11649","10596861",0,1,0,0,0,0
"11650","10596880",0,1,0,2,0,2
"11651","10596899",0,2,1,3,1,5
"11652","10596901",0,1,0,1,0,1
"11653","10596935",0,1,0,0,0,0
"11654","10596941",0,1,0,0,0,0
"11655","10596956",0,1,0,1,0,1
"11656","10596960",0,1,0,0,0,0
"11657","10596968",0,3,1,3,2,6
"11658","10596994",0,1,0,0,0,0
"11659","10596998",0,1,2,1,0,3
"11660","10597050",0,1,1,0,0,1
"11661","10597067",0,1,0,0,0,0
"11662","10597089",0,1,2,1,0,3
"11663","10597153",0,1,2,0,0,2
"11664","10597236",0,1,1,1,0,2
"11665","10597238",0,1,0,0,0,0
"11666","10597342",1,1,0,0,0,0
"11667","10597372",0,1,0,0,0,0
"11668","10597378",0,1,0,0,0,0
"11669","10597438",0,1,0,0,0,0
"11670","10597445",0,2,0,4,0,4
"11671","10597517",0,1,0,0,0,0
"11672","10597584",0,1,0,0,0,0
"11673","10597599",0,1,0,1,0,1
"11674","10597608",0,1,0,0,0,0
"11675","10597616",0,1,0,2,0,2
"11676","10597655",0,1,0,0,0,0
"11677","10597680",0,1,0,0,0,0
"11678","10597681",0,1,0,0,0,0
"11679","10597686",0,1,1,0,0,1
"11680","10597743",0,1,0,0,0,0
"11681","10597770",0,2,0,1,0,1
"11682","10597776",0,1,1,1,0,2
"11683","10597797",1,1,0,0,0,0
"11684","10597843",0,1,0,0,0,0
"11685","10597862",0,1,0,0,0,0
"11686","10597870",0,1,0,0,0,0
"11687","10597918",0,1,0,0,0,0
"11688","10597920",0,1,1,0,0,1
"11689","10597948",0,1,0,0,0,0
"11690","10597955",0,1,0,0,0,0
"11691","10597968",0,1,0,0,0,0
"11692","10597984",0,1,0,1,0,1
"11693","10598045",0,1,0,0,0,0
"11694","10598124",0,1,0,0,0,0
"11695","10598177",0,1,0,0,0,0
"11696","10598232",0,1,0,0,0,0
"11697","10598241",1,1,0,0,0,0
"11698","10598244",0,1,0,0,0,0
"11699","10598245",0,1,2,0,0,2
"11700","10598256",0,1,0,0,0,0
"11701","10598308",0,1,0,0,0,0
"11702","10598381",0,1,0,0,0,0
"11703","10598388",0,2,2,2,0,4
"11704","10598437",0,1,0,0,0,0
"11705","10598459",1,1,0,0,0,0
"11706","10598524",0,1,0,3,0,3
"11707","10598538",0,1,1,1,0,2
"11708","10598541",0,1,0,0,0,0
"11709","10598545",0,1,0,0,0,0
"11710","10598546",0,1,0,0,0,0
"11711","10598572",0,1,1,0,0,1
"11712","10598611",0,1,0,0,0,0
"11713","10598636",0,1,0,0,0,0
"11714","10598673",0,1,0,0,0,0
"11715","10598702",0,1,0,0,0,0
"11716","10598709",0,1,0,0,0,0
"11717","10598712",0,1,1,5,0,6
"11718","10598724",0,1,0,0,0,0
"11719","10598728",0,1,0,0,0,0
"11720","10598745",0,1,0,0,0,0
"11721","10598785",0,1,0,1,0,1
"11722","10598805",0,1,0,0,0,0
"11723","10598826",0,1,0,0,0,0
"11724","10598908",0,1,0,0,0,0
"11725","10598923",0,1,0,0,0,0
"11726","10598931",0,1,1,0,0,1
"11727","10598953",0,1,0,0,0,0
"11728","10599068",0,1,0,0,0,0
"11729","10599085",0,1,0,0,0,0
"11730","10599197",0,1,1,1,0,2
"11731","10599254",0,1,0,0,0,0
"11732","10599319",0,1,0,0,0,0
"11733","10599322",0,1,0,0,0,0
"11734","10599324",0,1,1,0,0,1
"11735","10599335",0,1,0,0,0,0
"11736","10599341",0,1,0,0,0,0
"11737","10599360",0,1,0,0,0,0
"11738","10599370",0,2,2,3,0,5
"11739","10599378",0,1,1,0,0,1
"11740","10599413",0,1,3,0,0,3
"11741","10599435",0,1,0,0,0,0
"11742","10599592",0,1,0,0,0,0
"11743","10599615",0,1,0,0,0,0
"11744","10599617",0,1,0,0,0,0
"11745","10599624",0,1,0,0,0,0
"11746","10599655",0,1,1,5,2,8
"11747","10599665",1,1,0,0,0,0
"11748","10599667",0,1,0,0,0,0
"11749","10599686",0,1,0,0,0,0
"11750","10599775",0,2,0,5,0,5
"11751","10599808",0,1,0,0,0,0
"11752","10599809",0,1,0,0,0,0
"11753","10599815",0,1,0,0,0,0
"11754","10599819",0,1,1,0,0,1
"11755","10599872",0,1,1,0,0,1
"11756","10599876",0,1,0,0,0,0
"11757","10599877",0,1,0,0,0,0
"11758","10599883",0,1,0,0,0,0
"11759","10599888",0,1,0,0,0,0
"11760","10599890",0,1,0,0,0,0
"11761","10599942",0,1,2,0,0,2
"11762","10599977",0,1,0,0,0,0
"11763","10600081",0,1,0,0,0,0
"11764","10600097",0,1,0,1,0,1
"11765","10600106",0,1,0,0,0,0
"11766","10600112",0,1,1,0,0,1
"11767","10600132",0,1,0,0,0,0
"11768","10600145",0,2,0,2,0,2
"11769","10600165",0,1,0,0,0,0
"11770","10600191",1,1,0,0,0,0
"11771","10600232",0,1,0,0,0,0
"11772","10600239",0,1,0,0,0,0
"11773","10600287",0,1,0,0,0,0
"11774","10600289",0,1,0,0,0,0
"11775","10600290",0,1,0,1,0,1
"11776","10600299",0,1,0,0,0,0
"11777","10600302",0,1,1,0,0,1
"11778","10600305",0,1,1,7,1,9
"11779","10600323",0,1,0,0,0,0
"11780","10600351",0,1,0,0,0,0
"11781","10600367",0,1,0,0,0,0
"11782","10600385",0,1,0,0,0,0
"11783","10600389",0,1,0,0,0,0
"11784","10600440",0,1,0,0,0,0
"11785","10600451",0,1,1,2,0,3
"11786","10600458",0,2,4,2,0,6
"11787","10600468",0,1,2,1,0,3
"11788","10600496",0,2,2,4,0,6
"11789","10600527",1,1,0,0,0,0
"11790","10600530",0,1,1,5,1,7
"11791","10600531",0,1,2,1,0,3
"11792","10600563",0,1,0,0,0,0
"11793","10600577",0,1,0,0,0,0
"11794","10600617",0,1,0,0,0,0
"11795","10600618",0,1,0,0,0,0
"11796","10600621",0,1,0,1,0,1
"11797","10600635",0,1,0,0,0,0
"11798","10600639",0,1,0,0,0,0
"11799","10600771",0,1,4,0,0,4
"11800","10600772",0,1,0,0,0,0
"11801","10600808",0,1,0,0,0,0
"11802","10600844",0,1,0,0,0,0
"11803","1222579",0,1,1,0,0,1
"11804","1222580",0,1,0,0,0,0
"11805","1222807",0,6,1,1,0,2
"11806","1223056",0,4,0,0,0,0
"11807","1223438",0,1,0,0,0,0
"11808","9000004",0,4,2,1,0,3
"11809","9000026",0,5,0,6,0,6
"11810","9000029",0,3,0,0,0,0
"11811","9000031",0,3,0,0,0,0
"11812","9000046",0,3,3,1,0,4
"11813","9000074",0,4,2,2,0,4
"11814","9000107",1,5,0,0,0,0
"11815","9000109",0,2,7,0,0,7
"11816","9000116",0,2,1,1,0,2
"11817","9000122",0,2,0,0,0,0
"11818","9000123",0,2,1,0,0,1
"11819","9000144",0,7,9,5,0,14
"11820","9000174",0,5,0,1,0,1
"11821","9000183",0,1,0,0,0,0
"11822","9000191",0,1,0,0,0,0
"11823","9000193",0,1,0,0,0,0
"11824","9000198",0,5,3,0,0,3
"11825","9000200",0,7,8,2,1,11
"11826","9000214",0,3,0,0,0,0
"11827","9000224",0,3,0,0,0,0
"11828","9000239",0,5,3,0,0,3
"11829","9000241",0,2,0,0,0,0
"11830","9000247",0,2,2,2,1,5
"11831","9000251",0,2,0,0,0,0
"11832","9000253",0,2,0,0,0,0
"11833","9000261",0,5,0,0,0,0
"11834","9000263",0,8,4,3,3,10
"11835","9000265",0,7,8,3,0,11
"11836","9000266",0,6,0,0,0,0
"11837","9000280",0,1,2,0,0,2
"11838","9000287",0,2,0,1,0,1
"11839","9000306",0,4,0,0,0,0
"11840","9000316",0,2,1,1,0,2
"11841","9000320",0,7,8,10,0,18
"11842","9000325",0,6,1,1,0,2
"11843","9000350",0,3,0,1,0,1
"11844","9000353",0,5,1,0,0,1
"11845","9000359",0,5,1,0,0,1
"11846","9000361",0,5,9,11,1,21
"11847","9000372",0,5,1,0,0,1
"11848","9000373",0,4,1,2,0,3
"11849","9000375",0,4,0,1,0,1
"11850","9000377",0,4,1,1,0,2
"11851","9000378",0,3,0,2,0,2
"11852","9000379",0,6,5,0,0,5
"11853","9000381",0,4,3,0,0,3
"11854","9000385",0,4,6,1,0,7
"11855","9000410",0,4,9,1,0,10
"11856","9000420",0,4,0,1,0,1
"11857","9000424",0,7,5,1,0,6
"11858","9000429",0,2,0,0,0,0
"11859","9000431",0,4,0,0,0,0
"11860","9000432",0,3,2,1,0,3
"11861","9000444",0,4,1,0,0,1
"11862","9000446",0,4,0,0,0,0
"11863","9000458",0,7,2,2,0,4
"11864","9000461",0,4,1,0,0,1
"11865","9000469",0,4,2,2,0,4
"11866","9000485",0,4,2,1,0,3
"11867","9000487",0,3,1,3,0,4
"11868","9000515",0,3,6,3,0,9
"11869","9000516",0,2,0,0,0,0
"11870","9000539",0,1,1,1,0,2
"11871","9000572",0,8,8,6,0,14
"11872","9000583",0,2,0,0,0,0
"11873","9000596",0,4,11,2,0,13
"11874","9000599",0,3,0,0,0,0
"11875","9000604",0,3,4,0,0,4
"11876","9000607",0,1,0,0,0,0
"11877","9000614",0,5,2,0,0,2
"11878","9000615",0,3,2,0,0,2
"11879","9000643",0,8,4,2,0,6
"11880","9000646",0,2,0,0,0,0
"11881","9000650",0,4,4,1,0,5
"11882","9000651",0,3,4,6,0,10
"11883","9000652",0,5,6,0,1,7
"11884","9000667",0,6,5,2,0,7
"11885","9000684",0,5,0,0,0,0
"11886","9000698",0,3,1,0,0,1
"11887","9000706",0,4,1,0,0,1
"11888","9000720",0,1,0,0,0,0
"11889","9000731",0,4,0,0,0,0
"11890","9000735",0,4,0,0,0,0
"11891","9000747",0,4,1,0,0,1
"11892","9000760",0,6,7,5,1,13
"11893","9000761",0,8,13,5,1,19
"11894","9000771",0,4,2,0,0,2
"11895","9000772",0,5,3,1,0,4
"11896","9000804",0,6,2,2,0,4
"11897","9000805",0,6,13,6,0,19
"11898","9000809",0,8,14,5,0,19
"11899","9000810",0,7,4,1,0,5
"11900","9000813",0,5,1,0,0,1
"11901","9000836",0,6,2,2,0,4
"11902","9000848",0,4,2,0,0,2
"11903","9000851",0,3,5,2,0,7
"11904","9000853",0,2,2,2,0,4
"11905","9000859",0,1,5,0,0,5
"11906","9000881",0,6,6,2,0,8
"11907","9000888",0,4,1,0,0,1
"11908","9000891",0,4,1,0,0,1
"11909","9000897",0,6,0,0,0,0
"11910","9000917",0,3,0,0,0,0
"11911","9000927",0,1,0,0,0,0
"11912","9000939",0,5,1,1,0,2
"11913","9000955",0,3,3,1,0,4
"11914","9000962",0,4,3,1,0,4
"11915","9000963",0,7,8,5,0,13
"11916","9000980",0,3,4,1,0,5
"11917","9000990",0,5,1,0,0,1
"11918","9000992",0,3,2,2,0,4
"11919","9000994",0,3,2,0,0,2
"11920","9001004",0,2,1,1,0,2
"11921","9001036",0,3,0,0,0,0
"11922","9001041",0,6,8,3,1,12
"11923","9001062",0,6,2,0,0,2
"11924","9001077",0,5,0,4,0,4
"11925","9001088",0,2,0,1,0,1
"11926","9001089",0,2,1,0,0,1
"11927","9001094",0,6,5,1,0,6
"11928","9001103",0,4,0,0,0,0
"11929","9001121",0,8,11,11,1,23
"11930","9001126",0,5,5,4,0,9
"11931","9001150",0,1,1,1,0,2
"11932","9001163",0,5,6,4,2,12
"11933","9001165",0,7,0,3,0,3
"11934","9001179",0,2,1,0,0,1
"11935","9001180",0,2,2,0,0,2
"11936","9001193",0,1,0,0,0,0
"11937","9001195",0,2,1,0,0,1
"11938","9001209",0,1,0,0,0,0
"11939","9001230",0,2,0,0,0,0
"11940","9001241",0,7,5,5,0,10
"11941","9001242",0,3,0,0,0,0
"11942","9001245",0,6,0,3,0,3
"11943","9001252",0,5,2,0,0,2
"11944","9001261",0,1,0,0,0,0
"11945","9001262",0,7,13,0,0,13
"11946","9001274",0,4,3,0,0,3
"11947","9001280",0,4,0,0,0,0
"11948","9001342",0,2,1,0,0,1
"11949","9001346",0,1,0,0,0,0
"11950","9001350",0,6,4,0,0,4
"11951","9001354",0,1,1,0,0,1
"11952","9001368",0,4,1,1,0,2
"11953","9001377",0,1,2,0,0,2
"11954","9001381",0,7,8,4,2,14
"11955","9001383",0,5,0,0,0,0
"11956","9001395",0,9,7,8,2,17
"11957","9001399",0,2,0,3,0,3
"11958","9001404",0,6,1,3,0,4
"11959","9001425",0,4,9,2,0,11
"11960","9001427",0,6,3,0,0,3
"11961","9001428",0,4,6,2,0,8
"11962","9001446",0,1,0,0,0,0
"11963","9001460",0,3,2,1,0,3
"11964","9001484",0,5,1,2,0,3
"11965","9001490",0,4,1,2,0,3
"11966","9001491",0,4,7,0,0,7
"11967","9001496",0,3,0,0,0,0
"11968","9001518",0,6,7,1,0,8
"11969","9001532",0,9,10,7,0,17
"11970","9001557",0,3,0,0,0,0
"11971","9001558",0,4,0,0,0,0
"11972","9001562",0,7,0,0,0,0
"11973","9001563",0,2,0,0,0,0
"11974","9001571",0,5,4,4,0,8
"11975","9001601",0,4,4,0,0,4
"11976","9001608",0,3,0,0,0,0
"11977","9001612",0,4,1,0,0,1
"11978","9001613",0,4,1,0,0,1
"11979","9001615",0,1,0,0,0,0
"11980","9001616",0,4,3,1,0,4
"11981","9001617",0,3,1,0,0,1
"11982","9001631",0,4,0,0,0,0
"11983","9001638",0,5,8,2,0,10
"11984","9001643",0,4,0,0,0,0
"11985","9001655",0,3,0,0,0,0
"11986","9001658",0,4,8,5,0,13
"11987","9001699",0,5,5,1,0,6
"11988","9001709",0,1,1,0,0,1
"11989","9001715",0,7,2,0,0,2
"11990","9001734",0,1,1,0,0,1
"11991","9001739",0,2,0,0,0,0
"11992","9001743",0,2,1,1,0,2
"11993","9001751",0,4,0,5,0,5
"11994","9001753",0,4,1,3,1,5
"11995","9001756",0,8,9,6,3,18
"11996","9001763",0,6,2,0,0,2
"11997","9001780",0,4,3,4,0,7
"11998","9001790",0,1,0,0,0,0
"11999","9001795",0,1,0,0,0,0
"12000","9001797",0,3,1,1,4,6
"12001","9001802",0,8,10,5,0,15
"12002","9001806",0,3,0,0,0,0
"12003","9001821",0,3,0,0,0,0
"12004","9001823",0,4,0,0,0,0
"12005","9001827",0,3,3,1,0,4
"12006","9001829",0,5,2,1,0,3
"12007","9001836",0,5,7,1,0,8
"12008","9001840",0,5,2,4,0,6
"12009","9001842",0,10,11,8,1,20
"12010","9001846",0,2,0,0,0,0
"12011","9001852",0,2,8,0,0,8
"12012","9001853",0,10,17,9,3,29
"12013","9001854",0,2,0,1,0,1
"12014","9001873",0,10,6,5,0,11
"12015","9001878",0,4,0,0,0,0
"12016","9001879",0,3,0,0,0,0
"12017","9001885",0,7,0,1,0,1
"12018","9001886",0,1,0,0,0,0
"12019","9001894",0,5,10,0,0,10
"12020","9001900",0,6,1,0,0,1
"12021","9001906",0,5,8,3,1,12
"12022","9001912",0,2,1,0,0,1
"12023","9001915",0,3,0,0,0,0
"12024","9001916",0,1,0,0,0,0
"12025","9001928",0,1,0,0,0,0
"12026","9001931",0,1,0,0,0,0
"12027","9001936",0,4,1,0,0,1
"12028","9001950",0,4,4,0,0,4
"12029","9001954",0,5,2,0,0,2
"12030","9001971",0,1,2,0,0,2
"12031","9001976",0,3,2,1,0,3
"12032","9001987",0,1,1,0,0,1
"12033","9001991",0,2,0,1,0,1
"12034","9001992",0,2,0,0,0,0
"12035","9001994",0,4,0,0,0,0
"12036","9002000",0,3,1,1,0,2
"12037","9002014",0,4,4,3,1,8
"12038","9002020",0,5,5,4,0,9
"12039","9002028",0,1,0,0,0,0
"12040","9002030",0,4,0,0,0,0
"12041","9002032",0,4,3,1,0,4
"12042","9002048",0,5,8,2,0,10
"12043","9002052",0,2,0,0,0,0
"12044","9002053",0,3,0,0,0,0
"12045","9002056",0,5,0,0,0,0
"12046","9002067",0,3,1,0,0,1
"12047","9002075",0,4,0,0,0,0
"12048","9002077",0,2,0,3,1,4
"12049","9002084",0,1,0,0,0,0
"12050","9002087",0,3,1,7,0,8
"12051","9002095",0,3,4,0,0,4
"12052","9002097",0,4,3,1,0,4
"12053","9002102",0,3,1,0,0,1
"12054","9002116",0,4,2,1,0,3
"12055","9002127",0,2,0,0,0,0
"12056","9002136",0,1,0,0,0,0
"12057","9002138",0,6,9,9,0,18
"12058","9002145",0,4,2,1,0,3
"12059","9002168",0,4,1,0,0,1
"12060","9002170",0,6,9,2,0,11
"12061","9002175",0,3,3,2,0,5
"12062","9002203",0,2,0,0,0,0
"12063","9002206",0,4,0,3,0,3
"12064","9002207",0,6,1,5,0,6
"12065","9002219",0,8,3,3,0,6
"12066","9002221",0,3,1,2,0,3
"12067","9002233",0,1,0,1,0,1
"12068","9002237",0,3,3,1,0,4
"12069","9002244",0,4,0,0,0,0
"12070","9002259",0,5,15,8,0,23
"12071","9002262",0,6,3,5,0,8
"12072","9002263",0,10,6,4,3,13
"12073","9002272",0,2,0,0,0,0
"12074","9002274",0,4,0,0,0,0
"12075","9002279",0,4,1,1,0,2
"12076","9002280",0,6,8,1,0,9
"12077","9002287",0,2,3,2,0,5
"12078","9002289",0,3,0,0,0,0
"12079","9002325",1,7,0,0,0,0
"12080","9002334",0,1,1,0,0,1
"12081","9002340",0,3,0,0,0,0
"12082","9002341",0,4,5,1,0,6
"12083","9002343",0,3,0,0,0,0
"12084","9002344",0,5,0,0,0,0
"12085","9002359",0,4,0,0,0,0
"12086","9002362",0,2,0,0,0,0
"12087","9002367",0,1,0,0,0,0
"12088","9002378",0,5,1,1,0,2
"12089","9002381",0,4,3,0,0,3
"12090","9002397",0,6,3,2,0,5
"12091","9002399",0,3,0,1,0,1
"12092","9002404",0,7,4,4,1,9
"12093","9002409",0,3,3,0,0,3
"12094","9002410",0,5,1,1,0,2
"12095","9002411",0,3,3,0,0,3
"12096","9002416",0,4,5,0,0,5
"12097","9002417",0,2,3,2,1,6
"12098","9002429",0,3,0,0,0,0
"12099","9002433",0,6,1,0,0,1
"12100","9002441",0,4,2,1,0,3
"12101","9002451",0,4,3,1,0,4
"12102","9002466",0,4,0,0,0,0
"12103","9002479",0,1,1,0,0,1
"12104","9002483",0,5,2,1,0,3
"12105","9002489",0,6,1,0,0,1
"12106","9002509",0,2,1,2,0,3
"12107","9002511",0,4,0,0,0,0
"12108","9002517",0,2,0,0,0,0
"12109","9002523",0,3,1,1,0,2
"12110","9002527",0,7,5,0,0,5
"12111","9002541",0,4,1,1,0,2
"12112","9002552",0,5,1,0,0,1
"12113","9002554",0,2,2,0,0,2
"12114","9002557",0,8,11,7,0,18
"12115","9002558",0,3,5,2,0,7
"12116","9002583",0,4,2,0,0,2
"12117","9002586",0,4,2,0,0,2
"12118","9002589",0,1,2,0,0,2
"12119","9002590",0,1,0,0,0,0
"12120","9002605",0,3,2,0,0,2
"12121","9002608",0,4,0,1,0,1
"12122","9002619",0,3,1,0,0,1
"12123","9002620",0,4,0,0,0,0
"12124","9002627",0,3,0,0,0,0
"12125","9002646",0,7,0,1,0,1
"12126","9002647",0,4,2,0,0,2
"12127","9002652",0,3,2,0,0,2
"12128","9002653",0,3,0,0,0,0
"12129","9002654",0,5,0,0,0,0
"12130","9002663",0,9,14,10,0,24
"12131","9002664",0,5,4,0,0,4
"12132","9002667",0,6,7,0,0,7
"12133","9002673",0,5,0,0,0,0
"12134","9002676",0,1,1,1,0,2
"12135","9002680",0,4,3,2,0,5
"12136","9002682",0,4,0,0,0,0
"12137","9002688",0,5,2,2,0,4
"12138","9002699",0,1,0,0,0,0
"12139","9002700",0,4,5,6,0,11
"12140","9002701",0,1,0,0,0,0
"12141","9002706",0,2,1,2,0,3
"12142","9002707",0,2,2,0,0,2
"12143","9002708",0,3,1,2,0,3
"12144","9002721",0,4,2,1,0,3
"12145","9002727",0,4,0,0,0,0
"12146","9002742",0,5,5,8,1,14
"12147","9002748",0,4,0,0,0,0
"12148","9002751",0,4,0,0,0,0
"12149","9002762",0,4,1,2,0,3
"12150","9002773",0,4,1,0,0,1
"12151","9002778",0,5,3,0,0,3
"12152","9002795",0,2,0,0,0,0
"12153","9002798",0,4,3,0,0,3
"12154","9002806",0,3,0,0,0,0
"12155","9002807",0,1,1,0,0,1
"12156","9002812",0,6,6,9,0,15
"12157","9002818",0,6,5,3,0,8
"12158","9002820",0,4,4,1,0,5
"12159","9002826",0,2,2,2,0,4
"12160","9002842",0,3,0,0,0,0
"12161","9002843",0,4,1,0,0,1
"12162","9002851",0,4,3,1,0,4
"12163","9002852",0,4,3,0,0,3
"12164","9002853",0,4,1,0,0,1
"12165","9002857",0,7,6,2,0,8
"12166","9002861",0,4,0,0,0,0
"12167","9002862",0,4,1,1,0,2
"12168","9002863",0,7,0,1,0,1
"12169","9002864",0,5,4,2,0,6
"12170","9002870",0,6,1,1,0,2
"12171","9002871",0,5,1,0,0,1
"12172","9002879",0,9,9,10,3,22
"12173","9002883",0,6,9,2,0,11
"12174","9002886",0,7,8,3,0,11
"12175","9002887",0,4,3,0,0,3
"12176","9002896",0,1,0,0,0,0
"12177","9002897",0,2,0,0,0,0
"12178","9002903",0,1,0,0,0,0
"12179","9002909",0,3,5,2,0,7
"12180","9002913",0,4,4,5,0,9
"12181","9002914",0,1,0,0,0,0
"12182","9002927",0,8,15,4,2,21
"12183","9002928",0,4,0,0,0,0
"12184","9002934",0,4,6,3,0,9
"12185","9002937",0,1,0,0,0,0
"12186","9002952",0,4,0,0,0,0
"12187","9002956",0,6,2,0,0,2
"12188","9002958",0,2,0,0,0,0
"12189","9002959",0,1,0,0,0,0
"12190","9002973",0,6,5,6,0,11
"12191","9002983",0,5,1,3,0,4
"12192","9002993",0,3,0,0,0,0
"12193","9002996",0,7,4,0,0,4
"12194","9002998",0,4,1,0,0,1
"12195","9003000",0,4,3,0,0,3
"12196","9003006",0,9,14,8,1,23
"12197","9003012",0,3,3,1,0,4
"12198","9003026",0,1,0,0,0,0
"12199","9003031",0,4,2,2,0,4
"12200","9003063",0,3,2,2,0,4
"12201","9003090",0,1,0,0,0,0
"12202","9003095",0,4,5,5,0,10
"12203","9003108",0,4,0,0,0,0
"12204","9003132",0,2,2,0,0,2
"12205","9003137",1,7,1,1,0,2
"12206","9003141",0,5,0,0,0,0
"12207","9003142",0,4,5,10,0,15
"12208","9003184",0,2,0,0,0,0
"12209","9003209",0,7,7,3,2,12
"12210","9003223",0,5,0,1,0,1
"12211","9003274",0,4,1,0,0,1
"12212","9003283",0,6,2,3,0,5
"12213","9003294",0,7,11,7,1,19
"12214","9003409",0,1,0,0,0,0
"12215","9003428",0,6,2,0,0,2
"12216","9003477",0,4,0,0,0,0
"12217","9003478",0,1,0,0,0,0
"12218","9003487",0,7,3,2,2,7
"12219","9003510",0,3,0,0,0,0
"12220","9003518",0,2,2,1,0,3
"12221","9003524",0,2,0,0,0,0
"12222","9003536",0,4,2,2,0,4
"12223","9003542",0,5,0,0,0,0
"12224","9003546",0,3,1,0,0,1
"12225","9003564",0,1,0,1,0,1
"12226","9003583",0,1,0,0,0,0
"12227","9003588",0,4,0,2,0,2
"12228","9003598",0,4,0,0,0,0
"12229","9003605",0,4,1,3,0,4
"12230","9003694",0,6,1,1,0,2
"12231","9003700",0,5,0,0,0,0
"12232","9003710",0,5,3,2,0,5
"12233","9003712",0,3,1,1,0,2
"12234","9003730",0,2,0,1,0,1
"12235","9003742",1,4,3,2,0,5
"12236","9003767",0,2,2,1,0,3
"12237","9003772",0,5,0,1,0,1
"12238","9003795",0,4,2,1,0,3
"12239","9003796",0,1,0,0,0,0
"12240","9003798",0,6,1,0,0,1
"12241","9003804",0,3,2,1,0,3
"12242","9003827",0,2,0,2,0,2
"12243","9003833",0,5,2,1,0,3
"12244","9003846",0,6,12,2,0,14
"12245","9003860",0,2,0,0,0,0
"12246","9003866",0,2,0,3,0,3
"12247","9003878",0,4,6,3,0,9
"12248","9003881",0,3,0,1,0,1
"12249","9003886",0,2,0,0,0,0
"12250","9003887",0,4,2,0,0,2
"12251","9003889",0,1,0,0,0,0
"12252","9003890",0,4,1,0,0,1
"12253","9003891",0,2,2,1,0,3
"12254","9003893",0,4,0,0,0,0
"12255","9003897",0,2,1,0,0,1
"12256","9003898",0,1,0,0,0,0
"12257","9003900",0,4,4,0,0,4
"12258","9003903",0,4,0,1,0,1
"12259","9003924",0,1,0,1,0,1
"12260","9003963",0,4,0,0,0,0
"12261","9003980",0,5,1,0,0,1
"12262","9003985",0,5,0,0,0,0
"12263","9003988",0,6,0,0,0,0
"12264","9003993",0,6,4,1,0,5
"12265","9003999",0,1,2,0,0,2
"12266","9004000",0,5,3,3,0,6
"12267","9004016",0,4,1,0,0,1
"12268","9004025",0,1,2,1,0,3
"12269","9004028",0,1,0,0,0,0
"12270","9004029",0,3,0,0,0,0
"12271","9004032",0,3,0,0,0,0
"12272","9004036",0,3,0,0,0,0
"12273","9004044",1,6,0,0,0,0
"12274","9004045",0,5,2,0,0,2
"12275","9004063",0,3,0,0,0,0
"12276","9004073",0,3,5,0,0,5
"12277","9004075",0,3,1,0,0,1
"12278","9004117",0,4,6,0,0,6
"12279","9004118",0,3,2,0,0,2
"12280","9004120",0,4,3,0,0,3
"12281","9004131",0,5,5,1,0,6
"12282","9004135",0,1,0,0,0,0
"12283","9004163",0,2,5,1,0,6
"12284","9004174",0,4,0,0,0,0
"12285","9004181",0,3,1,3,0,4
"12286","9004191",0,4,0,0,0,0
"12287","9004195",0,4,2,0,0,2
"12288","9004204",0,2,2,0,0,2
"12289","9004210",0,5,0,0,0,0
"12290","9004213",0,4,0,0,0,0
"12291","9004214",0,4,0,0,0,0
"12292","9004215",0,3,1,0,0,1
"12293","9004257",0,4,1,2,0,3
"12294","9004260",0,4,0,0,0,0
"12295","9004298",0,2,0,0,0,0
"12296","9004309",0,2,0,0,0,0
"12297","9004312",0,1,0,0,0,0
"12298","9004313",0,6,0,0,0,0
"12299","9004314",0,4,4,5,0,9
"12300","9004317",0,5,3,3,0,6
"12301","9004376",0,1,0,0,0,0
"12302","9004448",0,2,0,2,0,2
"12303","9004451",0,4,1,0,0,1
"12304","9004464",0,4,10,0,0,10
"12305","9004465",0,6,1,0,0,1
"12306","9004482",0,4,0,0,0,0
"12307","9004485",0,1,0,0,0,0
"12308","9004500",0,2,0,0,0,0
"12309","9004505",0,1,0,0,0,0
"12310","9004509",0,2,1,0,0,1
"12311","9004519",0,4,0,0,0,0
"12312","9004541",0,1,0,0,0,0
"12313","9004549",0,3,0,0,0,0
"12314","9004551",0,3,2,3,0,5
"12315","9004552",0,2,0,0,0,0
"12316","9004558",0,1,1,0,0,1
"12317","9004563",0,1,0,0,0,0
"12318","9004598",0,4,0,1,0,1
"12319","9004601",0,7,3,2,0,5
"12320","9004604",0,5,3,2,0,5
"12321","9004626",0,2,2,0,0,2
"12322","9004639",0,6,3,0,0,3
"12323","9004640",0,3,1,0,0,1
"12324","9004652",0,7,5,2,0,7
"12325","9004664",0,4,1,0,0,1
"12326","9004687",0,4,3,2,0,5
"12327","9004693",0,4,4,0,0,4
"12328","9004699",0,2,3,0,0,3
"12329","9004700",0,1,2,0,0,2
"12330","9004706",0,4,0,0,0,0
"12331","9004707",0,3,0,3,0,3
"12332","9004714",0,4,1,0,0,1
"12333","9004715",0,5,4,1,0,5
"12334","9004718",0,3,2,1,0,3
"12335","9004720",0,4,2,1,0,3
"12336","9004721",0,3,0,0,0,0
"12337","9004723",0,4,1,0,0,1
"12338","9004724",0,5,7,2,0,9
"12339","9004730",0,2,0,0,0,0
"12340","9004733",0,4,3,2,0,5
"12341","9004744",0,4,0,0,0,0
"12342","9004746",0,3,2,0,0,2
"12343","9004790",0,1,0,0,0,0
"12344","9004792",0,3,0,1,0,1
"12345","9004798",0,4,0,0,0,0
"12346","9004799",0,6,2,0,0,2
"12347","9004806",0,2,0,0,0,0
"12348","9004814",0,7,5,1,0,6
"12349","9004817",0,3,2,0,0,2
"12350","9004820",0,4,8,3,0,11
"12351","9004826",0,3,0,0,0,0
"12352","9004827",0,6,5,3,0,8
"12353","9004828",0,7,2,6,0,8
"12354","9004841",0,5,3,2,0,5
"12355","9004873",0,4,2,0,0,2
"12356","9004875",0,4,3,0,0,3
"12357","9004876",0,4,3,0,0,3
"12358","9004886",0,6,4,3,1,8
"12359","9004889",0,4,2,0,0,2
"12360","9004891",0,6,0,0,0,0
"12361","9004892",0,5,0,0,0,0
"12362","9004904",0,1,0,0,0,0
"12363","9004910",0,6,0,0,0,0
"12364","9004912",0,6,5,2,0,7
"12365","9004920",0,4,1,0,0,1
"12366","9004933",0,4,4,1,0,5
"12367","9004934",0,5,2,0,0,2
"12368","9004936",0,4,0,0,0,0
"12369","9004937",0,7,2,1,1,4
"12370","9004951",0,1,0,0,0,0
"12371","9004970",0,3,0,0,0,0
"12372","9004972",0,3,4,0,0,4
"12373","9004995",0,5,8,1,0,9
"12374","9005000",0,6,0,0,0,0
"12375","9005007",0,4,0,0,0,0
"12376","9005018",0,3,4,0,0,4
"12377","9005019",0,3,4,2,0,6
"12378","9005022",0,7,1,0,0,1
"12379","9005034",0,4,2,2,0,4
"12380","9005045",0,4,1,3,0,4
"12381","9005053",0,6,0,0,0,0
"12382","9005068",0,4,0,0,0,0
"12383","9005075",0,3,0,1,0,1
"12384","9005081",0,2,0,0,0,0
"12385","9005089",0,4,0,0,0,0
"12386","9005098",0,6,6,1,1,8
"12387","9005112",0,7,4,10,0,14
"12388","9005115",0,3,0,0,0,0
"12389","9005120",0,5,0,0,0,0
"12390","9005130",0,4,0,0,0,0
"12391","9005137",0,3,8,2,0,10
"12392","9005144",0,4,1,0,0,1
"12393","9005145",0,2,3,0,0,3
"12394","9005149",0,4,0,0,0,0
"12395","9005168",0,2,0,0,0,0
"12396","9005187",0,2,0,0,0,0
"12397","9005192",0,4,3,1,0,4
"12398","9005201",0,1,0,0,0,0
"12399","9005206",0,8,0,0,0,0
"12400","9005207",0,3,0,0,0,0
"12401","9005209",0,6,0,0,0,0
"12402","9005211",0,5,1,1,0,2
"12403","9005215",0,1,0,0,0,0
"12404","9005216",0,1,0,0,0,0
"12405","9005221",0,8,5,5,0,10
"12406","9005225",0,6,9,3,0,12
"12407","9005226",0,2,3,1,0,4
"12408","9005230",0,4,0,0,0,0
"12409","9005231",0,1,1,0,0,1
"12410","9005234",0,3,0,1,0,1
"12411","9005236",0,3,0,0,0,0
"12412","9005238",0,6,7,1,0,8
"12413","9005240",0,2,1,1,0,2
"12414","9005247",0,5,11,0,0,11
"12415","9005249",0,4,2,0,0,2
"12416","9005255",0,4,0,0,0,0
"12417","9005256",0,7,0,0,0,0
"12418","9005257",0,4,0,0,0,0
"12419","9005269",0,2,0,1,0,1
"12420","9005270",0,2,1,0,0,1
"12421","9005280",0,5,0,0,0,0
"12422","9005308",1,3,0,0,0,0
"12423","9005311",1,5,1,0,0,1
"12424","9005315",1,4,2,2,0,4
"12425","9005322",0,1,1,0,0,1
"12426","9005341",0,1,0,0,0,0
"12427","9005344",0,4,0,0,0,0
"12428","9005359",0,3,1,1,0,2
"12429","9005369",0,8,9,7,2,18
"12430","9005373",0,6,4,2,0,6
"12431","9005387",0,2,3,2,0,5
"12432","9005388",0,7,8,5,0,13
"12433","9005390",0,2,0,0,0,0
"12434","9005400",0,2,0,0,0,0
"12435","9005401",0,4,0,0,0,0
"12436","9005403",0,5,7,3,0,10
"12437","9005425",0,3,1,0,0,1
"12438","9005436",0,3,6,1,0,7
"12439","9005438",0,5,3,0,0,3
"12440","9005454",0,4,3,0,0,3
"12441","9005458",0,4,5,1,0,6
"12442","9005465",0,1,0,0,0,0
"12443","9005466",0,6,0,0,0,0
"12444","9005467",0,5,0,0,0,0
"12445","9005472",0,4,1,0,0,1
"12446","9005485",0,4,1,2,1,4
"12447","9005496",0,4,4,1,0,5
"12448","9005503",0,2,1,1,0,2
"12449","9005504",0,3,2,0,0,2
"12450","9005513",0,6,3,0,0,3
"12451","9005516",0,3,0,0,0,0
"12452","9005519",0,5,0,3,0,3
"12453","9005536",0,5,1,1,0,2
"12454","9005565",0,2,0,0,0,0
"12455","9005577",0,2,2,0,0,2
"12456","9005593",0,2,0,1,0,1
"12457","9005600",0,1,0,0,0,0
"12458","9005608",0,2,2,0,0,2
"12459","9005623",0,8,3,9,0,12
"12460","9005662",0,3,2,2,0,4
"12461","9005671",0,4,0,0,0,0
"12462","9005672",0,4,0,0,0,0
"12463","9005674",0,3,0,2,0,2
"12464","9005679",0,5,0,0,0,0
"12465","9005686",0,8,12,2,0,14
"12466","9005690",0,4,0,0,0,0
"12467","9005697",0,5,0,4,0,4
"12468","9005702",0,4,8,2,0,10
"12469","9005703",1,4,6,0,0,6
"12470","9005706",0,6,9,3,0,12
"12471","9005714",0,2,0,0,0,0
"12472","9005731",0,2,0,0,0,0
"12473","9005734",0,5,1,0,0,1
"12474","9005735",1,5,3,2,0,5
"12475","9005745",0,5,0,2,0,2
"12476","9005751",0,5,0,0,0,0
"12477","9005754",0,8,12,11,0,23
"12478","9005761",0,5,2,3,0,5
"12479","9005774",0,1,2,0,0,2
"12480","9005779",0,7,3,0,0,3
"12481","9005785",0,2,0,0,0,0
"12482","9005788",1,5,1,3,0,4
"12483","9005789",0,1,1,0,0,1
"12484","9005795",0,8,16,5,2,23
"12485","9005796",0,7,2,9,1,12
"12486","9005803",1,6,2,1,0,3
"12487","9005804",0,3,3,0,0,3
"12488","9005807",0,4,5,2,0,7
"12489","9005809",0,4,2,0,0,2
"12490","9005820",0,2,0,0,0,0
"12491","9005834",0,4,4,1,0,5
"12492","9005839",0,4,7,1,0,8
"12493","9005841",0,6,10,4,0,14
"12494","9005867",0,3,3,1,0,4
"12495","9005876",0,5,8,3,1,12
"12496","9005880",0,1,0,0,0,0
"12497","9005882",0,5,0,0,0,0
"12498","9005884",0,1,0,0,0,0
"12499","9005885",0,3,3,0,0,3
"12500","9005886",0,4,5,2,0,7
"12501","9005887",0,1,0,0,0,0
"12502","9005894",0,6,1,0,0,1
"12503","9005900",0,6,9,1,0,10
"12504","9005901",0,1,1,0,0,1
"12505","9005905",0,2,1,1,0,2
"12506","9005909",0,4,2,1,0,3
"12507","9005916",0,6,0,0,0,0
"12508","9005948",0,4,4,2,0,6
"12509","9005969",1,1,0,0,0,0
"12510","9005976",0,1,0,0,0,0
"12511","9005978",0,1,0,0,0,0
"12512","9005980",1,1,0,0,0,0
"12513","9005981",0,1,0,0,0,0
"12514","9005994",0,2,0,0,0,0
"12515","9005997",0,1,0,0,0,0
"12516","9006001",0,1,0,0,0,0
"12517","9006025",0,1,0,0,0,0
"12518","9006026",0,4,0,0,0,0
"12519","9006027",0,4,1,0,0,1
"12520","9006032",0,1,0,0,0,0
"12521","9006044",0,3,2,0,0,2
"12522","9006049",0,3,0,0,0,0
"12523","9006053",0,4,1,0,0,1
"12524","9006057",0,4,4,1,0,5
"12525","9006062",0,4,2,2,0,4
"12526","9006073",0,2,0,0,0,0
"12527","9006078",0,3,1,0,0,1
"12528","9006083",0,2,0,2,0,2
"12529","9006088",0,1,0,0,0,0
"12530","9006100",0,3,0,0,0,0
"12531","9006102",0,3,0,0,0,0
"12532","9006123",0,4,0,0,0,0
"12533","9006124",0,2,0,1,0,1
"12534","9006125",0,4,0,0,0,0
"12535","9006131",0,7,4,1,0,5
"12536","9006133",0,1,1,0,0,1
"12537","9006134",0,3,1,1,0,2
"12538","9006139",0,5,0,0,0,0
"12539","9006156",0,4,0,1,0,1
"12540","9006168",0,4,1,0,0,1
"12541","9006174",0,3,0,0,0,0
"12542","9006177",0,1,0,0,0,0
"12543","9006179",0,4,2,0,0,2
"12544","9006182",0,6,0,0,0,0
"12545","9006188",0,2,2,3,0,5
"12546","9006195",0,2,0,0,0,0
"12547","9006221",0,4,4,5,0,9
"12548","9006227",0,5,3,1,0,4
"12549","9006235",0,6,2,0,0,2
"12550","9006248",0,1,1,0,0,1
"12551","9006249",0,4,0,0,0,0
"12552","9006253",0,5,1,6,0,7
"12553","9006263",0,5,7,3,0,10
"12554","9006275",0,5,0,0,0,0
"12555","9006277",0,3,0,0,0,0
"12556","9006289",0,5,2,8,2,12
"12557","9006293",0,4,5,1,0,6
"12558","9006295",0,8,13,7,1,21
"12559","9006296",0,6,0,0,0,0
"12560","9006305",0,7,5,2,0,7
"12561","9006308",0,1,0,0,0,0
"12562","9006329",0,4,4,0,0,4
"12563","9006347",0,9,3,8,3,14
"12564","9006350",0,3,0,0,0,0
"12565","9006368",0,4,3,3,0,6
"12566","9006369",0,2,0,0,0,0
"12567","9006377",0,4,2,0,0,2
"12568","9006391",0,3,3,0,0,3
"12569","9006393",0,4,2,2,0,4
"12570","9006394",0,4,2,0,0,2
"12571","9006400",0,6,5,1,0,6
"12572","9006413",0,6,7,2,0,9
"12573","9006439",0,4,3,2,0,5
"12574","9006454",0,1,1,0,0,1
"12575","9006460",0,7,7,4,2,13
"12576","9006461",0,10,7,0,1,8
"12577","9006472",0,3,0,0,0,0
"12578","9006480",0,4,1,2,0,3
"12579","9006493",0,5,3,0,0,3
"12580","9006503",0,4,0,1,0,1
"12581","9006504",0,4,0,0,0,0
"12582","9006509",0,4,6,2,0,8
"12583","9006518",0,5,3,3,0,6
"12584","9006520",0,4,7,1,0,8
"12585","9006522",0,4,1,0,0,1
"12586","9006523",0,4,6,3,0,9
"12587","9006524",0,6,6,2,0,8
"12588","9006532",0,5,1,0,0,1
"12589","9006541",0,6,1,0,0,1
"12590","9006542",0,3,0,0,0,0
"12591","9006551",0,4,5,0,0,5
"12592","9006552",0,1,0,0,0,0
"12593","9006559",0,4,4,0,0,4
"12594","9006575",0,4,0,0,0,0
"12595","9006584",0,7,5,2,0,7
"12596","9006627",0,3,4,0,0,4
"12597","9006633",0,7,0,0,0,0
"12598","9006653",0,7,7,5,0,12
"12599","9006655",0,3,1,0,0,1
"12600","9006664",0,1,0,0,0,0
"12601","9006667",0,6,2,1,0,3
"12602","9006670",0,6,0,0,0,0
"12603","9006674",0,6,7,4,0,11
"12604","9006676",0,4,0,0,0,0
"12605","9006678",0,4,0,0,0,0
"12606","9006679",0,2,0,0,0,0
"12607","9006680",0,2,0,0,0,0
"12608","9006682",0,7,2,1,0,3
"12609","9006683",0,4,2,1,0,3
"12610","9006710",0,7,3,12,0,15
"12611","9006712",0,5,3,1,0,4
"12612","9006714",0,2,0,0,0,0
"12613","9006743",0,1,1,0,0,1
"12614","9006777",0,5,3,7,0,10
"12615","9006789",0,3,4,1,0,5
"12616","9006796",0,1,0,0,0,0
"12617","9006800",0,2,0,0,0,0
"12618","9006803",0,5,1,0,0,1
"12619","9006809",0,3,1,0,0,1
"12620","9006812",0,1,0,0,0,0
"12621","9006817",0,3,3,0,0,3
"12622","9006819",0,1,0,0,0,0
"12623","9006824",0,1,0,0,0,0
"12624","9006866",0,1,0,0,0,0
"12625","9006874",0,8,8,2,0,10
"12626","9006877",0,7,7,12,0,19
"12627","9006885",0,5,2,0,0,2
"12628","9006896",0,5,1,3,0,4
"12629","9006898",0,5,0,0,0,0
"12630","9006908",0,4,2,0,0,2
"12631","9006921",0,4,0,0,0,0
"12632","9006928",0,4,0,0,0,0
"12633","9006933",0,3,3,2,0,5
"12634","9006936",0,2,0,0,0,0
"12635","9006939",0,4,0,0,0,0
"12636","9006943",0,2,0,1,0,1
"12637","9006951",0,6,3,2,0,5
"12638","9006977",0,4,1,2,0,3
"12639","9006980",0,3,10,4,0,14
"12640","9006991",0,2,0,0,0,0
"12641","9007002",0,4,0,0,0,0
"12642","9007009",0,3,0,0,0,0
"12643","9007011",0,1,0,0,0,0
"12644","9007013",0,1,0,1,0,1
"12645","9007021",0,7,0,0,0,0
"12646","9007026",0,2,0,0,0,0
"12647","9007042",0,4,1,1,0,2
"12648","9007047",0,3,5,2,0,7
"12649","9007062",0,4,2,0,0,2
"12650","9007066",0,1,0,0,0,0
"12651","9007081",1,6,6,3,0,9
"12652","9007087",1,6,2,0,0,2
"12653","9007091",0,3,0,2,0,2
"12654","9007093",0,7,2,2,0,4
"12655","9007144",0,4,2,1,0,3
"12656","9007145",0,4,0,0,0,0
"12657","9007146",0,6,3,7,0,10
"12658","9007162",0,4,2,0,0,2
"12659","9007163",0,8,6,6,1,13
"12660","9007179",0,3,0,1,0,1
"12661","9007184",0,1,1,0,0,1
"12662","9007196",0,5,0,0,0,0
"12663","9007197",0,6,0,0,0,0
"12664","9007200",0,4,1,1,0,2
"12665","9007208",0,3,1,1,0,2
"12666","9007215",0,3,1,0,0,1
"12667","9007219",0,4,0,0,0,0
"12668","9007221",0,3,2,0,0,2
"12669","9007224",0,11,8,8,5,21
"12670","9007228",0,4,3,2,1,6
"12671","9007237",0,3,0,0,0,0
"12672","9007244",0,5,0,1,0,1
"12673","9007245",0,3,0,0,0,0
"12674","9007247",0,6,3,3,0,6
"12675","9007272",0,4,8,2,0,10
"12676","9007308",0,1,0,0,0,0
"12677","9007315",0,3,0,0,0,0
"12678","9007324",0,5,0,0,0,0
"12679","9007340",0,6,1,0,0,1
"12680","9007348",0,6,3,0,0,3
"12681","9007351",1,4,2,1,0,3
"12682","9007358",0,4,0,1,0,1
"12683","9007370",0,4,0,0,0,0
"12684","9007383",0,3,1,2,0,3
"12685","9007387",0,6,4,3,0,7
"12686","9007395",0,1,0,0,0,0
"12687","9007398",0,4,4,1,0,5
"12688","9007399",0,7,4,4,0,8
"12689","9007401",0,5,3,0,0,3
"12690","9007413",0,2,3,0,0,3
"12691","9007429",0,4,4,0,0,4
"12692","9007462",0,1,0,0,0,0
"12693","9007463",0,1,0,0,0,0
"12694","9007469",0,4,4,0,0,4
"12695","9007487",0,1,0,0,0,0
"12696","9007489",0,8,9,10,3,22
"12697","9007494",0,4,1,0,0,1
"12698","9007496",0,3,2,5,1,8
"12699","9007500",0,3,3,2,0,5
"12700","9007502",0,2,0,0,0,0
"12701","9007504",0,3,1,1,0,2
"12702","9007515",0,7,7,2,0,9
"12703","9007542",0,1,0,0,0,0
"12704","9007549",0,6,1,0,0,1
"12705","9007554",0,4,5,0,0,5
"12706","9007590",0,1,0,0,0,0
"12707","9007604",0,4,5,0,0,5
"12708","9007616",0,3,0,0,0,0
"12709","9007627",0,4,1,0,0,1
"12710","9007634",0,4,4,1,0,5
"12711","9007645",0,1,0,0,0,0
"12712","9007652",0,7,16,5,0,21
"12713","9007663",0,1,0,0,0,0
"12714","9007665",0,3,0,1,0,1
"12715","9007672",0,1,0,0,0,0
"12716","9007674",0,4,0,0,0,0
"12717","9007685",0,5,7,3,1,11
"12718","9007686",0,1,1,0,0,1
"12719","9007694",0,1,0,0,0,0
"12720","9007697",0,1,0,0,0,0
"12721","9007702",0,5,5,2,0,7
"12722","9007711",0,2,0,0,0,0
"12723","9007716",0,4,0,0,0,0
"12724","9007717",0,4,3,0,0,3
"12725","9007719",0,3,0,0,0,0
"12726","9007721",0,4,0,0,0,0
"12727","9007722",0,2,0,0,0,0
"12728","9007731",0,7,11,4,0,15
"12729","9007734",0,1,0,0,0,0
"12730","9007736",0,6,0,0,0,0
"12731","9007748",0,2,1,0,0,1
"12732","9007750",0,6,6,1,0,7
"12733","9007752",0,6,0,0,0,0
"12734","9007758",0,4,5,5,0,10
"12735","9007762",0,4,0,1,0,1
"12736","9007763",0,1,0,0,0,0
"12737","9007768",0,6,0,1,0,1
"12738","9007771",0,6,2,1,0,3
"12739","9007779",1,4,0,1,0,1
"12740","9007783",0,4,0,2,0,2
"12741","9007812",0,4,0,1,0,1
"12742","9007814",1,4,4,1,0,5
"12743","9007819",0,2,1,0,0,1
"12744","9007848",0,4,0,0,0,0
"12745","9007852",0,3,0,0,0,0
"12746","9007867",0,2,0,0,0,0
"12747","9007879",0,6,3,0,0,3
"12748","9007883",0,1,0,0,0,0
"12749","9007889",0,3,1,0,0,1
"12750","9007890",0,4,0,0,0,0
"12751","9007893",0,3,2,1,0,3
"12752","9007897",0,4,0,0,0,0
"12753","9007906",0,1,0,0,0,0
"12754","9007916",0,5,5,2,0,7
"12755","9007930",0,1,0,0,0,0
"12756","9007945",0,1,0,0,0,0
"12757","9007962",0,2,2,0,0,2
"12758","9007964",0,4,1,0,0,1
"12759","9007968",0,4,1,0,0,1
"12760","9007970",0,4,3,3,0,6
"12761","9007972",0,7,0,0,0,0
"12762","9007974",0,5,2,0,0,2
"12763","9007988",0,5,0,0,0,0
"12764","9007997",0,2,0,0,0,0
"12765","9008005",0,2,4,2,2,8
"12766","9008018",0,1,0,0,0,0
"12767","9008020",0,1,0,0,0,0
"12768","9008026",0,4,4,0,0,4
"12769","9008029",0,4,4,0,0,4
"12770","9008031",0,3,2,0,0,2
"12771","9008042",0,6,3,0,0,3
"12772","9008064",0,4,1,0,0,1
"12773","9008065",0,1,0,0,0,0
"12774","9008071",0,2,1,1,0,2
"12775","9008079",0,4,0,0,0,0
"12776","9008083",0,3,0,0,0,0
"12777","9008099",0,4,0,0,0,0
"12778","9008104",0,6,3,1,0,4
"12779","9008110",0,4,0,0,0,0
"12780","9008116",0,1,1,0,0,1
"12781","9008118",0,6,0,0,0,0
"12782","9008127",0,2,0,0,0,0
"12783","9008137",0,8,11,7,3,21
"12784","9008157",0,5,5,0,0,5
"12785","9008159",0,2,0,0,0,0
"12786","9008181",0,1,0,1,0,1
"12787","9008188",0,2,0,0,0,0
"12788","9008189",0,3,0,0,0,0
"12789","9008191",0,5,1,1,0,2
"12790","9008194",0,6,0,1,0,1
"12791","9008208",0,2,0,0,0,0
"12792","9008210",0,7,0,0,0,0
"12793","9008213",0,4,0,0,0,0
"12794","9008214",0,6,0,0,0,0
"12795","9008215",0,4,1,0,0,1
"12796","9008220",0,3,1,0,0,1
"12797","9008227",0,8,13,6,1,20
"12798","9008228",0,4,0,0,0,0
"12799","9008229",0,5,0,0,0,0
"12800","9008244",0,5,2,4,0,6
"12801","9008274",0,5,1,0,0,1
"12802","9008283",0,2,0,0,0,0
"12803","9008285",0,6,8,0,0,8
"12804","9008291",0,6,0,0,0,0
"12805","9008306",0,3,0,0,0,0
"12806","9008310",0,3,0,0,0,0
"12807","9008311",0,4,0,0,0,0
"12808","9008312",0,2,0,0,0,0
"12809","9008316",0,6,6,0,0,6
"12810","9008319",0,8,2,0,0,2
"12811","9008329",1,4,1,0,0,1
"12812","9008330",0,6,3,2,0,5
"12813","9008343",0,4,0,0,0,0
"12814","9008374",0,5,3,0,0,3
"12815","9008380",0,1,0,1,0,1
"12816","9008383",0,4,3,1,0,4
"12817","9008391",0,4,1,1,0,2
"12818","9008396",0,7,10,6,0,16
"12819","9008402",0,6,11,1,0,12
"12820","9008405",0,4,7,5,0,12
"12821","9008411",0,6,5,15,1,21
"12822","9008429",0,4,0,0,0,0
"12823","9008454",0,3,0,0,0,0
"12824","9008466",0,5,0,0,0,0
"12825","9008476",0,9,9,5,0,14
"12826","9008478",0,3,1,0,0,1
"12827","9008486",0,5,3,5,0,8
"12828","9008497",1,4,0,2,0,2
"12829","9008498",0,2,1,0,0,1
"12830","9008513",0,6,5,6,0,11
"12831","9008515",0,5,7,2,0,9
"12832","9008529",0,5,7,1,0,8
"12833","9008531",0,5,3,1,0,4
"12834","9008532",0,5,6,3,1,10
"12835","9008533",0,5,9,0,0,9
"12836","9008553",0,5,0,0,1,1
"12837","9008565",0,3,0,0,0,0
"12838","9008567",0,6,10,5,0,15
"12839","9008575",0,2,3,1,0,4
"12840","9008581",0,4,0,0,0,0
"12841","9008582",0,6,0,0,0,0
"12842","9008588",0,5,1,0,0,1
"12843","9008589",0,6,0,0,0,0
"12844","9008603",0,6,2,5,0,7
"12845","9008604",0,6,0,0,0,0
"12846","9008606",0,4,3,3,0,6
"12847","9008619",0,2,0,0,0,0
"12848","9008628",0,2,0,0,0,0
"12849","9008629",0,4,1,3,0,4
"12850","9008633",0,3,4,0,0,4
"12851","9008650",0,5,0,0,0,0
"12852","9008656",0,6,5,0,0,5
"12853","9008665",0,7,0,0,0,0
"12854","9008670",0,5,0,1,0,1
"12855","9008702",0,5,4,2,0,6
"12856","9008705",0,4,0,0,0,0
"12857","9008707",0,3,0,0,0,0
"12858","9008708",0,3,1,0,0,1
"12859","9008710",0,8,0,2,0,2
"12860","9008733",0,5,4,2,0,6
"12861","9008737",0,6,4,1,0,5
"12862","9008741",0,4,3,0,0,3
"12863","9008744",0,4,0,0,0,0
"12864","9008751",0,7,0,0,0,0
"12865","9008770",0,1,0,0,0,0
"12866","9008776",0,1,0,0,0,0
"12867","9008783",0,3,2,0,0,2
"12868","9008788",0,6,1,0,0,1
"12869","9008789",0,5,10,0,0,10
"12870","9008805",0,2,0,2,0,2
"12871","9008823",0,3,0,0,0,0
"12872","9008830",0,2,1,0,0,1
"12873","9008848",0,2,0,0,0,0
"12874","9008888",0,3,5,1,0,6
"12875","9008894",0,5,4,2,0,6
"12876","9008926",0,2,0,0,0,0
"12877","9008927",0,3,1,0,0,1
"12878","9008934",1,6,4,2,0,6
"12879","9008938",0,4,0,0,0,0
"12880","9008945",0,6,0,0,0,0
"12881","9008955",0,3,2,0,0,2
"12882","9008957",0,4,2,2,0,4
"12883","9008963",0,4,3,0,0,3
"12884","9008977",0,6,1,2,0,3
"12885","9009011",0,4,6,1,0,7
"12886","9009033",0,5,13,4,0,17
"12887","9009038",0,3,0,0,0,0
"12888","9009044",0,5,3,0,0,3
"12889","9009063",0,1,0,0,0,0
"12890","9009091",0,4,0,0,0,0
"12891","9009094",0,4,0,0,0,0
"12892","9009095",0,4,6,1,0,7
"12893","9009097",0,4,0,0,0,0
"12894","9009098",0,4,0,2,0,2
"12895","9009103",0,4,1,0,0,1
"12896","9009136",0,3,0,0,0,0
"12897","9009150",0,7,1,1,2,4
"12898","9009151",0,4,0,0,0,0
"12899","9009155",0,1,2,0,0,2
"12900","9009175",0,6,9,2,0,11
"12901","9009181",0,2,0,0,0,0
"12902","9009186",0,2,0,0,0,0
"12903","9009192",0,4,1,1,0,2
"12904","9009208",0,5,0,1,0,1
"12905","9009210",0,1,1,1,0,2
"12906","9009217",0,1,0,0,0,0
"12907","9009220",0,6,0,1,0,1
"12908","9009228",0,1,0,0,0,0
"12909","9009237",0,1,0,0,0,0
"12910","9009250",0,1,0,0,0,0
"12911","9009256",0,4,0,1,0,1
"12912","9009262",0,2,0,0,0,0
"12913","9009263",0,2,1,1,0,2
"12914","9009281",0,2,0,0,0,0
"12915","9009282",0,4,0,0,0,0
"12916","9009286",0,4,7,0,0,7
"12917","9009289",0,3,0,0,0,0
"12918","9009291",0,4,2,0,0,2
"12919","9009326",0,1,1,3,0,4
"12920","9009332",0,1,0,0,0,0
"12921","9009353",0,5,1,3,0,4
"12922","9009360",0,4,5,1,0,6
"12923","9009376",0,3,2,0,0,2
"12924","9009389",0,1,0,0,0,0
"12925","9009394",0,4,1,0,0,1
"12926","9009398",0,2,0,0,0,0
"12927","9009402",0,3,0,0,0,0
"12928","9009420",0,1,0,0,0,0
"12929","9009424",0,4,7,3,0,10
"12930","9009425",1,6,0,1,0,1
"12931","9009427",0,5,2,2,0,4
"12932","9009431",1,6,0,1,0,1
"12933","9009437",0,4,0,0,0,0
"12934","9009447",0,2,5,1,0,6
"12935","9009451",0,8,2,1,0,3
"12936","9009454",0,6,0,0,0,0
"12937","9009456",0,3,1,0,0,1
"12938","9009457",0,4,0,0,0,0
"12939","9009463",0,1,0,0,0,0
"12940","9009473",0,3,3,0,0,3
"12941","9009497",0,5,2,0,0,2
"12942","9009504",0,10,5,7,6,18
"12943","9009514",0,7,12,4,0,16
"12944","9009519",0,8,7,2,0,9
"12945","9009520",0,4,5,2,0,7
"12946","9009524",0,7,1,0,0,1
"12947","9009539",0,1,2,0,0,2
"12948","9009574",0,3,0,0,0,0
"12949","9009577",0,1,0,0,0,0
"12950","9009584",0,3,3,1,0,4
"12951","9009585",0,3,4,1,0,5
"12952","9009588",0,6,5,4,1,10
"12953","9009590",0,5,0,0,0,0
"12954","9009593",0,4,6,2,0,8
"12955","9009597",0,4,2,0,0,2
"12956","9009619",0,2,1,3,0,4
"12957","9009640",1,4,0,0,0,0
"12958","9009643",0,1,0,0,0,0
"12959","9009645",0,8,4,3,0,7
"12960","9009647",0,1,0,0,0,0
"12961","9009669",0,6,1,0,0,1
"12962","9009707",0,1,0,1,0,1
"12963","9009709",0,5,0,1,0,1
"12964","9009721",0,4,3,1,0,4
"12965","9009726",0,2,0,1,0,1
"12966","9009727",0,1,1,0,0,1
"12967","9009730",0,6,1,0,0,1
"12968","9009731",0,4,4,0,0,4
"12969","9009741",0,3,0,0,0,0
"12970","9009746",0,4,2,1,0,3
"12971","9009749",0,5,5,1,0,6
"12972","9009750",0,4,1,0,0,1
"12973","9009757",0,3,0,0,0,0
"12974","9009762",0,7,2,0,0,2
"12975","9009767",0,1,0,0,0,0
"12976","9009777",0,4,7,3,0,10
"12977","9009781",0,7,11,5,0,16
"12978","9009785",0,6,3,1,0,4
"12979","9009791",0,2,0,1,0,1
"12980","9009800",0,6,6,3,1,10
"12981","9009801",0,5,0,0,0,0
"12982","9009803",0,9,6,7,0,13
"12983","9009805",0,4,2,1,0,3
"12984","9009811",0,4,2,0,0,2
"12985","9009813",0,4,2,0,0,2
"12986","9009834",0,2,2,0,0,2
"12987","9009835",0,2,0,0,0,0
"12988","9009838",0,2,0,0,0,0
"12989","9009839",0,4,1,0,0,1
"12990","9009846",0,4,1,3,0,4
"12991","9009849",0,4,1,0,0,1
"12992","9009856",0,4,2,0,0,2
"12993","9009863",0,4,0,0,0,0
"12994","9009866",0,3,4,1,0,5
"12995","9009867",0,3,1,0,0,1
"12996","9009871",0,4,5,2,0,7
"12997","9009875",0,4,1,4,0,5
"12998","9009890",0,5,5,1,0,6
"12999","9009893",0,4,0,0,0,0
"13000","9009895",0,4,3,3,0,6
"13001","9009896",0,10,9,2,0,11
"13002","9009897",0,4,2,0,0,2
"13003","9009902",0,5,3,2,0,5
"13004","9009903",0,3,0,0,0,0
"13005","9009907",0,4,2,1,0,3
"13006","9009909",0,3,2,0,0,2
"13007","9009914",0,3,4,1,0,5
"13008","9009917",0,7,5,3,0,8
"13009","9009918",0,6,0,0,0,0
"13010","9009921",0,6,7,2,0,9
"13011","9009925",0,6,1,0,0,1
"13012","9009946",0,6,1,2,0,3
"13013","9009948",0,6,0,2,0,2
"13014","9009949",0,2,1,0,0,1
"13015","9009975",0,6,3,1,0,4
"13016","9010004",0,1,0,0,0,0
"13017","9010005",0,3,3,0,0,3
"13018","9010007",0,6,5,3,0,8
"13019","9010011",0,6,1,6,0,7
"13020","9010014",0,4,0,1,0,1
"13021","9010017",0,5,1,0,0,1
"13022","9010032",0,2,0,0,0,0
"13023","9010034",0,6,0,1,0,1
"13024","9010038",1,6,0,0,0,0
"13025","9010067",0,6,3,0,0,3
"13026","9010068",0,2,6,0,0,6
"13027","9010069",0,6,6,2,0,8
"13028","9010070",0,4,7,0,0,7
"13029","9010073",0,2,0,2,0,2
"13030","9010075",0,4,0,1,0,1
"13031","9010089",0,3,2,1,0,3
"13032","9010093",0,9,6,7,4,17
"13033","9010113",0,1,0,0,0,0
"13034","9010121",0,3,2,1,0,3
"13035","9010129",0,4,0,1,0,1
"13036","9010130",0,1,0,1,0,1
"13037","9010142",0,1,0,0,0,0
"13038","9010151",0,1,0,0,0,0
"13039","9010155",0,4,6,0,0,6
"13040","9010159",0,5,0,0,0,0
"13041","9010177",0,3,0,0,0,0
"13042","9010183",0,4,0,0,0,0
"13043","9010185",0,1,2,0,0,2
"13044","9010217",0,5,0,0,1,1
"13045","9010245",0,7,6,5,0,11
"13046","9010247",0,4,1,0,0,1
"13047","9010256",0,7,6,2,1,9
"13048","9010258",0,2,1,0,0,1
"13049","9010269",0,4,0,0,0,0
"13050","9010270",0,4,1,2,0,3
"13051","9010271",0,4,0,0,0,0
"13052","9010278",0,4,0,0,0,0
"13053","9010307",0,4,0,3,0,3
"13054","9010309",0,6,2,0,0,2
"13055","9010316",0,6,10,1,0,11
"13056","9010318",0,2,1,0,0,1
"13057","9010320",0,2,1,0,0,1
"13058","9010322",0,2,0,0,0,0
"13059","9010327",0,2,0,1,0,1
"13060","9010334",0,1,0,0,0,0
"13061","9010335",0,2,0,0,0,0
"13062","9010345",0,7,1,1,0,2
"13063","9010363",0,4,0,0,0,0
"13064","9010365",0,4,1,0,0,1
"13065","9010372",0,5,0,0,0,0
"13066","9010373",0,4,0,0,0,0
"13067","9010378",0,4,1,1,0,2
"13068","9010388",0,6,0,2,0,2
"13069","9010398",0,3,0,0,0,0
"13070","9010403",0,4,3,0,0,3
"13071","9010421",0,10,5,7,0,12
"13072","9010422",0,5,2,3,0,5
"13073","9010429",0,1,0,0,0,0
"13074","9010431",0,6,0,0,0,0
"13075","9010434",0,1,0,0,0,0
"13076","9010457",0,3,1,0,0,1
"13077","9010463",0,5,0,1,0,1
"13078","9010470",0,4,0,0,0,0
"13079","9010479",0,6,3,2,0,5
"13080","9010483",0,1,0,0,0,0
"13081","9010491",0,2,0,3,0,3
"13082","9010505",0,5,4,0,0,4
"13083","9010508",0,5,3,1,0,4
"13084","9010509",0,1,0,0,0,0
"13085","9010539",0,1,1,1,0,2
"13086","9010550",0,3,0,0,0,0
"13087","9010570",0,4,1,0,0,1
"13088","9010604",0,1,1,1,0,2
"13089","9010627",1,5,2,1,0,3
"13090","9010638",0,4,0,0,0,0
"13091","9010639",0,4,0,0,0,0
"13092","9010643",0,12,14,5,8,27
"13093","9010660",0,4,4,2,0,6
"13094","9010670",0,4,1,0,0,1
"13095","9010676",0,6,6,5,0,11
"13096","9010705",0,1,0,0,0,0
"13097","9010712",0,1,0,0,0,0
"13098","9010718",0,1,0,0,0,0
"13099","9010721",0,6,1,1,0,2
"13100","9010723",0,4,9,1,0,10
"13101","9010727",0,2,0,0,0,0
"13102","9010735",1,4,3,0,0,3
"13103","9010771",0,1,0,0,0,0
"13104","9010782",0,4,0,0,0,0
"13105","9010795",0,3,1,2,0,3
"13106","9010808",0,3,0,0,0,0
"13107","9010813",0,7,5,7,1,13
"13108","9010820",0,7,3,2,0,5
"13109","9010863",0,4,0,0,0,0
"13110","9010864",0,4,2,1,0,3
"13111","9010888",0,6,1,1,0,2
"13112","9010899",0,4,1,2,0,3
"13113","9010904",0,1,3,0,0,3
"13114","9010915",0,3,6,5,0,11
"13115","9010928",0,4,2,0,0,2
"13116","9010932",0,8,4,4,0,8
"13117","9010935",0,4,0,0,0,0
"13118","9010949",0,5,0,0,0,0
"13119","9010989",0,7,1,0,0,1
"13120","9011013",0,2,1,0,0,1
"13121","9011014",0,1,0,0,0,0
"13122","9011016",0,5,2,0,0,2
"13123","9011038",0,4,3,1,0,4
"13124","9011043",0,1,3,1,0,4
"13125","9011047",0,1,0,0,0,0
"13126","9011049",0,4,5,0,0,5
"13127","9011050",0,1,0,0,0,0
"13128","9011052",0,3,0,0,0,0
"13129","9011055",0,2,0,0,0,0
"13130","9011056",0,5,0,0,0,0
"13131","9011057",0,6,4,3,0,7
"13132","9011064",0,6,0,1,0,1
"13133","9011071",0,8,26,7,3,36
"13134","9011077",0,3,2,0,0,2
"13135","9011078",0,4,0,0,0,0
"13136","9011089",0,3,0,0,0,0
"13137","9011090",0,3,0,0,0,0
"13138","9011093",0,4,1,3,0,4
"13139","9011099",0,6,7,1,0,8
"13140","9011100",0,7,9,3,1,13
"13141","9011101",0,8,3,2,3,8
"13142","9011102",0,12,5,5,1,11
"13143","9011112",0,6,6,3,1,10
"13144","9011113",0,5,4,3,0,7
"13145","9011115",0,4,2,2,1,5
"13146","9011140",0,1,0,0,0,0
"13147","9011145",0,1,0,0,0,0
"13148","9011156",0,3,0,1,0,1
"13149","9011158",0,4,0,1,0,1
"13150","9011160",0,3,1,0,0,1
"13151","9011168",0,4,3,2,0,5
"13152","9011185",0,3,2,1,0,3
"13153","9011191",0,4,0,1,0,1
"13154","9011196",0,3,0,0,0,0
"13155","9011206",0,2,1,2,0,3
"13156","9011208",0,6,1,0,0,1
"13157","9011216",0,1,0,0,0,0
"13158","9011221",0,5,0,0,0,0
"13159","9011227",0,4,0,0,0,0
"13160","9011230",0,2,0,0,0,0
"13161","9011231",0,1,0,0,0,0
"13162","9011239",0,4,1,1,0,2
"13163","9011256",0,4,3,1,0,4
"13164","9011271",0,7,3,3,0,6
"13165","9011273",0,4,4,0,0,4
"13166","9011276",0,4,1,5,0,6
"13167","9011285",0,3,7,0,0,7
"13168","9011291",0,5,5,1,0,6
"13169","9011295",0,1,0,0,0,0
"13170","9011303",0,1,0,0,0,0
"13171","9011322",0,3,0,0,0,0
"13172","9011329",0,4,7,5,0,12
"13173","9011358",0,6,2,0,0,2
"13174","9011366",0,3,4,1,0,5
"13175","9011370",0,6,0,0,0,0
"13176","9011400",0,7,7,3,0,10
"13177","9011402",0,3,1,0,0,1
"13178","9011410",0,3,1,0,0,1
"13179","9011417",0,3,0,0,0,0
"13180","9011424",0,6,0,0,0,0
"13181","9011430",0,2,0,0,0,0
"13182","9011437",0,6,5,0,2,7
"13183","9011438",0,1,0,0,0,0
"13184","9011449",0,4,0,0,0,0
"13185","9011456",0,4,2,1,0,3
"13186","9011460",0,4,0,0,0,0
"13187","9011462",0,3,2,1,0,3
"13188","9011465",0,7,7,0,0,7
"13189","9011469",0,5,2,1,0,3
"13190","9011472",0,1,0,0,0,0
"13191","9011476",0,5,6,6,0,12
"13192","9011489",0,4,4,6,0,10
"13193","9011491",0,7,0,1,1,2
"13194","9011494",0,1,1,4,0,5
"13195","9011506",0,6,4,3,0,7
"13196","9011510",0,4,4,0,0,4
"13197","9011522",0,1,0,0,0,0
"13198","9011544",0,4,1,0,0,1
"13199","9011546",0,7,3,5,1,9
"13200","9011566",0,1,0,0,0,0
"13201","9011567",0,6,1,5,0,6
"13202","9011607",0,6,4,0,0,4
"13203","9011619",0,3,0,0,0,0
"13204","9011629",0,1,0,0,0,0
"13205","9011637",0,2,0,0,0,0
"13206","9011639",0,1,0,0,0,0
"13207","9011640",0,6,4,0,0,4
"13208","9011650",0,5,1,0,0,1
"13209","9011651",0,7,0,0,0,0
"13210","9011656",0,4,0,0,0,0
"13211","9011659",0,4,0,0,0,0
"13212","9011663",0,2,2,0,0,2
"13213","9011664",0,5,3,0,0,3
"13214","9011666",0,1,0,0,0,0
"13215","9011689",0,3,0,0,0,0
"13216","9011705",0,3,2,1,0,3
"13217","9011712",0,5,7,1,0,8
"13218","9011714",0,5,2,0,0,2
"13219","9011721",0,5,4,1,0,5
"13220","9011734",0,1,0,0,0,0
"13221","9011739",0,4,0,0,0,0
"13222","9011741",0,7,5,1,1,7
"13223","9011746",0,1,0,0,0,0
"13224","9011754",0,6,7,0,0,7
"13225","9011758",0,4,2,0,0,2
"13226","9011759",0,3,1,0,0,1
"13227","9011764",0,7,4,4,0,8
"13228","9011783",0,6,8,6,1,15
"13229","9011785",0,3,2,0,0,2
"13230","9011786",0,3,1,0,0,1
"13231","9011790",0,3,1,0,0,1
"13232","9011814",0,3,0,1,0,1
"13233","9011820",0,4,1,1,0,2
"13234","9011824",0,16,20,21,8,49
"13235","9011828",0,6,10,4,0,14
"13236","9011839",0,1,0,0,0,0
"13237","9011841",0,3,0,2,0,2
"13238","9011855",0,3,0,0,0,0
"13239","9011861",0,3,0,0,0,0
"13240","9011895",0,2,1,0,0,1
"13241","9011896",0,1,0,0,0,0
"13242","9011898",0,1,0,0,0,0
"13243","9011902",0,1,0,0,0,0
"13244","9011905",0,1,0,0,0,0
"13245","9011906",0,2,0,0,0,0
"13246","9011911",0,1,0,0,0,0
"13247","9011912",0,1,0,0,0,0
"13248","9011918",0,1,0,0,0,0
"13249","9011921",0,2,1,0,0,1
"13250","9011922",0,2,0,0,0,0
"13251","9011924",0,3,0,0,0,0
"13252","9011929",0,1,0,0,0,0
"13253","9011940",0,6,6,3,0,9
"13254","9011944",0,4,6,0,0,6
"13255","9011951",0,6,2,1,0,3
"13256","9011952",0,8,12,9,1,22
"13257","9011954",0,6,7,6,0,13
"13258","9011955",0,9,8,6,2,16
"13259","9011956",0,7,6,3,0,9
"13260","9011960",0,2,0,0,0,0
"13261","9011985",0,4,2,3,0,5
"13262","9011990",0,1,0,0,0,0
"13263","9011993",0,6,10,4,0,14
"13264","9011996",0,8,8,8,0,16
"13265","9012046",0,1,0,1,0,1
"13266","9012047",0,1,0,0,0,0
"13267","9012048",0,3,0,0,0,0
"13268","9012067",1,5,0,0,0,0
"13269","9012071",0,3,2,2,0,4
"13270","9012082",0,4,0,0,0,0
"13271","9012122",0,5,4,0,0,4
"13272","9012124",0,4,2,2,0,4
"13273","9012132",0,4,0,0,0,0
"13274","9012151",0,3,1,0,0,1
"13275","9012155",0,4,0,0,0,0
"13276","9012170",0,3,2,1,0,3
"13277","9012190",0,4,0,0,0,0
"13278","9012195",0,4,7,2,0,9
"13279","9012198",0,4,1,0,0,1
"13280","9012203",0,2,0,0,0,0
"13281","9012206",0,3,0,0,0,0
"13282","9012209",0,4,0,0,0,0
"13283","9012230",0,5,1,0,0,1
"13284","9012240",0,3,0,1,0,1
"13285","9012245",0,3,1,0,0,1
"13286","9012250",0,3,0,0,0,0
"13287","9012255",0,5,1,3,0,4
"13288","9012260",0,4,0,0,0,0
"13289","9012261",0,4,1,2,0,3
"13290","9012262",0,2,1,0,0,1
"13291","9012269",0,4,0,0,0,0
"13292","9012272",0,4,1,0,0,1
"13293","9012276",0,4,5,0,0,5
"13294","9012294",0,5,1,0,0,1
"13295","9012296",0,5,6,3,0,9
"13296","9012306",0,1,0,0,0,0
"13297","9012308",0,5,3,1,0,4
"13298","9012313",0,5,4,0,0,4
"13299","9012314",0,6,1,1,0,2
"13300","9012319",0,3,1,1,0,2
"13301","9012348",0,1,0,0,0,0
"13302","9012356",0,2,1,1,0,2
"13303","9012363",0,2,4,0,0,4
"13304","9012364",0,5,3,3,1,7
"13305","9012367",0,2,0,0,0,0
"13306","9012373",0,5,6,1,0,7
"13307","9012377",0,4,6,0,0,6
"13308","9012378",0,5,8,4,0,12
"13309","9012379",0,2,1,0,0,1
"13310","9012389",0,4,3,0,0,3
"13311","9012390",0,4,2,0,0,2
"13312","9012397",0,4,0,0,0,0
"13313","9012404",0,5,5,1,0,6
"13314","9012421",0,3,1,3,0,4
"13315","9012423",0,3,0,0,0,0
"13316","9012437",0,4,5,3,0,8
"13317","9012438",0,5,6,2,1,9
"13318","9012500",0,2,1,0,0,1
"13319","9012507",0,3,0,1,0,1
"13320","9012517",0,5,0,0,0,0
"13321","9012522",0,5,2,0,0,2
"13322","9012525",0,4,0,0,0,0
"13323","9012526",0,4,0,0,0,0
"13324","9012540",0,6,1,0,0,1
"13325","9012546",0,4,6,1,0,7
"13326","9012550",0,2,0,0,0,0
"13327","9012552",0,1,0,0,0,0
"13328","9012560",0,5,3,4,0,7
"13329","9012561",0,5,1,3,0,4
"13330","9012562",0,5,6,2,0,8
"13331","9012573",0,3,0,0,0,0
"13332","9012586",0,1,1,0,0,1
"13333","9012596",0,3,1,0,0,1
"13334","9012600",0,6,10,3,1,14
"13335","9012607",0,3,3,1,0,4
"13336","9012610",0,7,5,2,0,7
"13337","9012617",0,5,0,1,0,1
"13338","9012631",0,5,2,0,0,2
"13339","9012645",0,1,0,0,0,0
"13340","9012646",0,5,4,0,0,4
"13341","9012668",0,1,0,0,0,0
"13342","9012679",0,9,9,4,2,15
"13343","9012687",0,3,3,0,0,3
"13344","9012697",0,7,5,1,2,8
"13345","9012698",0,5,4,7,1,12
"13346","9012724",0,5,4,1,0,5
"13347","9012737",0,7,2,1,0,3
"13348","9012744",0,7,0,0,0,0
"13349","9012750",0,1,0,0,0,0
"13350","9012752",0,3,0,0,0,0
"13351","9012753",0,4,1,1,0,2
"13352","9012758",0,3,1,0,0,1
"13353","9012761",0,1,0,0,0,0
"13354","9012762",0,5,2,0,0,2
"13355","9012773",0,4,0,0,0,0
"13356","9012780",0,4,0,0,0,0
"13357","9012783",0,6,4,3,0,7
"13358","9012785",0,5,1,1,0,2
"13359","9012786",0,4,3,1,0,4
"13360","9012790",0,4,0,0,0,0
"13361","9012804",0,2,0,3,0,3
"13362","9012820",0,2,0,1,0,1
"13363","9012821",0,4,3,1,0,4
"13364","9012834",0,1,0,0,0,0
"13365","9012866",0,1,1,0,0,1
"13366","9012868",0,9,7,4,1,12
"13367","9012878",0,5,0,1,0,1
"13368","9012883",0,1,0,0,0,0
"13369","9012886",0,3,4,3,0,7
"13370","9012889",0,4,0,0,0,0
"13371","9012891",0,2,1,1,0,2
"13372","9012892",0,3,6,0,0,6
"13373","9012893",0,2,0,0,0,0
"13374","9012903",1,6,5,5,0,10
"13375","9012906",0,9,14,20,3,37
"13376","9012912",0,5,0,0,0,0
"13377","9012920",0,9,12,8,1,21
"13378","9012941",0,2,0,0,0,0
"13379","9012944",0,6,2,0,0,2
"13380","9012946",0,1,0,0,0,0
"13381","9012950",0,1,0,1,0,1
"13382","9012953",0,2,0,0,0,0
"13383","9012959",0,4,0,0,0,0
"13384","9012963",0,5,4,0,0,4
"13385","9012968",0,1,0,0,0,0
"13386","9012975",0,4,7,0,0,7
"13387","9012979",0,5,12,3,1,16
"13388","9012981",0,4,0,0,0,0
"13389","9012982",0,1,0,0,0,0
"13390","9013018",0,4,1,2,0,3
"13391","9013019",0,1,1,0,0,1
"13392","9013031",0,1,0,0,0,0
"13393","9013032",0,7,4,4,0,8
"13394","9013035",0,4,3,2,0,5
"13395","9013040",0,1,0,0,0,0
"13396","9013048",0,4,0,0,0,0
"13397","9013050",0,2,0,0,0,0
"13398","9013058",0,2,0,0,0,0
"13399","9013059",0,7,3,4,0,7
"13400","9013060",0,7,0,0,0,0
"13401","9013074",0,4,0,0,0,0
"13402","9013081",0,2,0,2,0,2
"13403","9013085",0,1,0,0,0,0
"13404","9013088",0,1,0,0,0,0
"13405","9013089",0,5,2,4,0,6
"13406","9013096",0,5,0,0,0,0
"13407","9013099",0,1,0,0,0,0
"13408","9013107",0,4,1,2,0,3
"13409","9013126",0,4,6,1,0,7
"13410","9013132",0,3,0,0,0,0
"13411","9013137",0,4,0,0,0,0
"13412","9013144",1,1,0,1,0,1
"13413","9013147",1,4,2,1,0,3
"13414","9013151",0,4,8,1,0,9
"13415","9013154",0,2,4,4,0,8
"13416","9013157",0,1,0,0,0,0
"13417","9013165",0,4,0,0,0,0
"13418","9013166",0,1,0,1,0,1
"13419","9013168",0,6,2,4,0,6
"13420","9013175",0,2,0,0,0,0
"13421","9013178",0,4,3,2,0,5
"13422","9013210",0,4,0,0,0,0
"13423","9013215",0,2,0,0,0,0
"13424","9013218",0,4,1,1,0,2
"13425","9013222",0,6,0,5,1,6
"13426","9013225",0,1,0,0,0,0
"13427","9013226",0,3,0,0,0,0
"13428","9013230",0,4,1,0,0,1
"13429","9013231",0,2,2,3,0,5
"13430","9013234",0,4,2,0,0,2
"13431","9013240",0,4,6,3,1,10
"13432","9013256",0,7,1,1,0,2
"13433","9013257",0,4,1,2,0,3
"13434","9013259",0,4,0,1,0,1
"13435","9013263",0,6,4,0,0,4
"13436","9013265",0,4,5,2,0,7
"13437","9013267",0,2,1,0,0,1
"13438","9013276",0,2,1,0,0,1
"13439","9013285",0,1,3,0,0,3
"13440","9013294",0,6,0,0,0,0
"13441","9013296",0,2,0,0,0,0
"13442","9013311",0,6,1,0,0,1
"13443","9013329",0,3,0,0,0,0
"13444","9013337",0,6,3,0,0,3
"13445","9013364",0,4,0,1,0,1
"13446","9013366",0,7,7,9,0,16
"13447","9013367",0,5,0,0,0,0
"13448","9013368",0,5,1,1,0,2
"13449","9013369",0,5,3,5,0,8
"13450","9013371",0,5,2,2,1,5
"13451","9013374",0,1,0,0,0,0
"13452","9013382",0,2,2,1,0,3
"13453","9013389",0,11,5,13,6,24
"13454","9013394",0,2,0,0,0,0
"13455","9013398",0,1,0,0,0,0
"13456","9013430",0,5,8,1,0,9
"13457","9013437",0,4,0,0,0,0
"13458","9013438",0,6,0,0,0,0
"13459","9013442",0,4,0,1,0,1
"13460","9013454",0,4,0,0,0,0
"13461","9013460",0,4,3,1,0,4
"13462","9013467",0,5,8,1,0,9
"13463","9013491",0,3,0,2,0,2
"13464","9013492",0,5,8,1,0,9
"13465","9013500",0,6,3,0,0,3
"13466","9013503",0,4,2,0,0,2
"13467","9013518",0,4,2,1,0,3
"13468","9013525",0,7,12,3,1,16
"13469","9013529",0,1,0,0,0,0
"13470","9013535",0,1,0,0,0,0
"13471","9013540",0,4,2,0,0,2
"13472","9013545",0,4,11,4,0,15
"13473","9013555",0,4,0,0,0,0
"13474","9013557",0,6,1,0,0,1
"13475","9013573",0,6,0,0,0,0
"13476","9013574",0,3,1,0,0,1
"13477","9013576",0,5,1,0,0,1
"13478","9013579",0,4,0,0,0,0
"13479","9013581",0,2,0,0,0,0
"13480","9013592",0,2,4,4,0,8
"13481","9013594",0,1,0,0,0,0
"13482","9013595",0,5,2,2,0,4
"13483","9013602",0,4,2,0,0,2
"13484","9013622",0,7,5,1,0,6
"13485","9013663",0,6,2,0,0,2
"13486","9013666",0,7,2,0,0,2
"13487","9013669",0,3,6,0,0,6
"13488","9013676",0,2,0,0,0,0
"13489","9013680",0,4,3,2,0,5
"13490","9013681",0,5,3,3,1,7
"13491","9013682",0,2,0,2,0,2
"13492","9013693",0,1,0,0,0,0
"13493","9013708",0,3,2,0,0,2
"13494","9013740",0,1,3,2,0,5
"13495","9013745",0,4,0,0,0,0
"13496","9013772",0,3,0,0,0,0
"13497","9013774",0,4,2,1,0,3
"13498","9013777",0,6,10,6,0,16
"13499","9013779",0,4,0,0,0,0
"13500","9013781",0,4,0,0,0,0
"13501","9013784",0,2,0,0,0,0
"13502","9013789",0,8,4,3,0,7
"13503","9013797",0,4,0,0,0,0
"13504","9013803",0,3,0,0,0,0
"13505","9013810",0,4,0,0,0,0
"13506","9013813",0,4,0,2,0,2
"13507","9013816",0,4,5,4,0,9
"13508","9013817",0,4,2,0,0,2
"13509","9013819",0,5,7,0,0,7
"13510","9013822",0,2,2,1,0,3
"13511","9013825",0,5,0,0,0,0
"13512","9013829",0,4,0,0,0,0
"13513","9013831",0,5,0,0,0,0
"13514","9013837",0,2,0,0,0,0
"13515","9013840",0,4,1,2,0,3
"13516","9013850",0,1,0,0,0,0
"13517","9013860",0,4,2,0,0,2
"13518","9013883",0,3,0,0,0,0
"13519","9013915",0,3,0,3,0,3
"13520","9013918",0,4,1,0,0,1
"13521","9013922",0,1,0,0,0,0
"13522","9013923",0,1,1,0,0,1
"13523","9013924",0,3,4,0,0,4
"13524","9013925",0,7,1,1,0,2
"13525","9013953",0,1,0,0,0,0
"13526","9013954",0,4,4,0,0,4
"13527","9013955",0,4,0,0,0,0
"13528","9013966",0,5,2,0,0,2
"13529","9013967",0,3,2,0,0,2
"13530","9013968",0,3,4,0,0,4
"13531","9013989",0,1,0,0,0,0
"13532","9013994",0,1,1,0,0,1
"13533","9014001",0,1,0,0,0,0
"13534","9014020",0,1,0,0,0,0
"13535","9014021",0,2,0,0,0,0
"13536","9014026",0,1,2,0,0,2
"13537","9014027",0,2,0,0,0,0
"13538","9014031",0,1,0,0,0,0
"13539","9014036",0,2,0,0,0,0
"13540","9014054",0,1,0,0,0,0
"13541","9014056",0,2,0,0,0,0
"13542","9014057",0,1,1,0,0,1
"13543","9014060",0,2,3,0,0,3
"13544","9014066",0,4,3,1,0,4
"13545","9014071",0,7,8,0,0,8
"13546","9014076",0,5,0,0,0,0
"13547","9014091",0,8,6,5,2,13
"13548","9014097",0,6,0,0,0,0
"13549","9014098",0,6,0,1,0,1
"13550","9014099",0,3,0,0,0,0
"13551","9014103",0,7,6,5,2,13
"13552","9014113",0,1,0,0,0,0
"13553","9014125",0,2,0,0,0,0
"13554","9014127",0,1,0,0,0,0
"13555","9014133",0,4,0,0,0,0
"13556","9014140",0,1,1,0,0,1
"13557","9014154",0,3,1,0,0,1
"13558","9014164",0,10,12,20,3,35
"13559","9014168",0,3,3,0,0,3
"13560","9014180",0,4,0,0,0,0
"13561","9014182",0,4,1,0,0,1
"13562","9014191",0,6,14,4,0,18
"13563","9014192",0,3,0,0,0,0
"13564","9014216",0,5,4,0,0,4
"13565","9014224",0,5,2,0,0,2
"13566","9014228",0,4,1,0,0,1
"13567","9014233",0,5,6,1,0,7
"13568","9014254",0,1,0,0,0,0
"13569","9014263",0,3,1,1,0,2
"13570","9014265",0,6,0,0,0,0
"13571","9014270",0,1,2,0,0,2
"13572","9014293",0,6,12,3,1,16
"13573","9014302",0,4,0,0,0,0
"13574","9014309",0,5,5,0,0,5
"13575","9014311",0,1,0,0,0,0
"13576","9014314",0,4,1,0,0,1
"13577","9014315",0,5,4,2,0,6
"13578","9014340",0,1,0,0,0,0
"13579","9014364",0,4,0,2,0,2
"13580","9014366",0,5,2,9,0,11
"13581","9014371",0,6,3,2,0,5
"13582","9014392",0,6,2,5,0,7
"13583","9014396",0,6,2,0,0,2
"13584","9014402",0,5,3,1,0,4
"13585","9014403",0,3,0,0,0,0
"13586","9014409",0,3,6,0,0,6
"13587","9014413",0,2,0,0,0,0
"13588","9014416",0,3,4,0,0,4
"13589","9014440",0,4,0,0,0,0
"13590","9014446",0,5,1,3,0,4
"13591","9014452",0,5,5,2,0,7
"13592","9014453",0,5,0,0,0,0
"13593","9014454",0,5,2,0,0,2
"13594","9014457",0,1,0,0,0,0
"13595","9014458",0,6,2,1,0,3
"13596","9014460",0,4,2,0,0,2
"13597","9014463",0,4,4,1,0,5
"13598","9014464",0,2,0,0,0,0
"13599","9014470",0,6,8,5,0,13
"13600","9014475",0,3,0,0,0,0
"13601","9014479",0,5,6,1,0,7
"13602","9014480",0,3,1,0,0,1
"13603","9014482",0,5,3,2,0,5
"13604","9014486",0,5,0,1,0,1
"13605","9014487",0,4,0,1,0,1
"13606","9014488",0,6,0,0,0,0
"13607","9014492",0,4,4,0,0,4
"13608","9014493",0,5,0,0,0,0
"13609","9014505",0,2,1,6,0,7
"13610","9014507",0,1,0,0,0,0
"13611","9014513",0,4,0,0,0,0
"13612","9014516",0,3,2,0,0,2
"13613","9014517",0,5,4,1,0,5
"13614","9014518",0,4,0,0,0,0
"13615","9014538",0,8,0,0,0,0
"13616","9014549",0,2,0,0,0,0
"13617","9014553",0,5,0,0,0,0
"13618","9014555",0,3,1,0,0,1
"13619","9014567",0,6,0,0,0,0
"13620","9014569",0,1,0,1,0,1
"13621","9014571",0,4,0,0,0,0
"13622","9014573",0,4,2,0,0,2
"13623","9014587",0,1,0,0,0,0
"13624","9014608",0,1,0,0,0,0
"13625","9014609",0,2,0,0,0,0
"13626","9014610",0,2,0,0,0,0
"13627","9014614",0,1,0,0,0,0
"13628","9014618",0,3,0,0,0,0
"13629","9014619",0,1,2,0,0,2
"13630","9014620",0,5,3,3,0,6
"13631","9014625",0,1,0,0,0,0
"13632","9014628",0,2,1,1,0,2
"13633","9014632",0,3,1,0,0,1
"13634","9014634",0,1,0,0,0,0
"13635","9014636",0,1,0,0,0,0
"13636","9014640",0,2,1,0,0,1
"13637","9014642",0,2,1,1,0,2
"13638","9014643",0,3,0,0,0,0
"13639","9014644",0,2,0,0,0,0
"13640","9014645",0,2,1,1,0,2
"13641","9014646",0,3,0,1,0,1
"13642","9014648",0,3,1,0,0,1
"13643","9014653",0,3,0,0,0,0
"13644","9014685",0,2,0,0,0,0
"13645","9014688",0,6,0,0,0,0
"13646","9014696",0,7,18,8,1,27
"13647","9014706",0,1,0,0,0,0
"13648","9014722",0,2,0,0,0,0
"13649","9014729",0,2,0,0,0,0
"13650","9014733",0,6,9,2,1,12
"13651","9014736",0,2,1,0,0,1
"13652","9014741",0,4,1,0,0,1
"13653","9014743",0,3,4,0,0,4
"13654","9014745",0,1,0,0,0,0
"13655","9014747",0,1,0,0,0,0
"13656","9014763",0,4,4,2,0,6
"13657","9014773",1,4,2,1,0,3
"13658","9014774",0,5,0,0,1,1
"13659","9014777",1,6,2,1,0,3
"13660","9014782",0,3,0,0,0,0
"13661","9014790",0,4,1,0,0,1
"13662","9014792",0,1,0,0,0,0
"13663","9014795",0,3,5,0,0,5
"13664","9014809",0,3,1,2,0,3
"13665","9014810",0,3,0,1,0,1
"13666","9014833",0,2,0,0,0,0
"13667","9014840",0,2,0,0,0,0
"13668","9014854",0,1,2,0,0,2
"13669","9014877",0,2,0,0,0,0
"13670","9014880",0,2,0,0,0,0
"13671","9014888",0,4,1,0,0,1
"13672","9014892",0,1,0,0,0,0
"13673","9014909",0,2,6,1,0,7
"13674","9014914",0,1,0,0,0,0
"13675","9014919",0,2,1,0,0,1
"13676","9014922",0,4,0,3,0,3
"13677","9014925",0,6,10,2,0,12
"13678","9014940",0,4,2,1,0,3
"13679","9014947",0,3,0,1,0,1
"13680","9014949",0,4,3,0,0,3
"13681","9014955",0,3,0,0,0,0
"13682","9014960",0,3,2,0,0,2
"13683","9014961",0,2,3,1,0,4
"13684","9014967",0,3,2,0,0,2
"13685","9014969",0,4,1,0,0,1
"13686","9014986",0,8,16,4,3,23
"13687","9014989",0,6,0,0,0,0
"13688","9014990",0,3,1,1,0,2
"13689","9014999",0,3,1,0,0,1
"13690","9015004",0,2,0,2,0,2
"13691","9015011",0,4,1,3,0,4
"13692","9015014",0,7,3,1,1,5
"13693","9015029",0,1,0,0,0,0
"13694","9015044",0,3,2,3,0,5
"13695","9015063",0,6,0,0,0,0
"13696","9015086",0,8,10,10,1,21
"13697","9015095",0,6,5,0,0,5
"13698","9015099",0,6,15,2,0,17
"13699","9015120",0,1,0,0,0,0
"13700","9015124",0,2,1,0,0,1
"13701","9015125",0,8,9,5,1,15
"13702","9015143",0,4,2,0,0,2
"13703","9015162",0,2,1,0,0,1
"13704","9015167",0,3,3,1,0,4
"13705","9015199",0,5,7,4,0,11
"13706","9015206",0,1,0,0,0,0
"13707","9015217",0,7,11,4,0,15
"13708","9015234",0,2,0,0,0,0
"13709","9015240",0,4,0,0,0,0
"13710","9015284",0,2,0,0,0,0
"13711","9015291",0,2,0,0,0,0
"13712","9015317",0,2,0,0,0,0
"13713","9015320",0,3,0,0,0,0
"13714","9015325",0,4,8,9,1,18
"13715","9015327",0,4,4,0,0,4
"13716","9015341",0,6,4,5,1,10
"13717","9015342",0,8,11,7,3,21
"13718","9015347",0,2,0,0,0,0
"13719","9015351",0,7,5,3,0,8
"13720","9015378",0,5,5,3,0,8
"13721","9015382",0,6,2,3,0,5
"13722","9015392",0,9,13,9,2,24
"13723","9015401",0,1,0,0,0,0
"13724","9015409",0,1,1,0,0,1
"13725","9015411",0,1,0,0,0,0
"13726","9015418",0,3,2,1,0,3
"13727","9015419",0,5,4,0,0,4
"13728","9015423",0,2,5,2,0,7
"13729","9015435",0,5,0,0,0,0
"13730","9015438",0,3,3,0,0,3
"13731","9015449",0,7,6,5,0,11
"13732","9015451",0,6,0,0,0,0
"13733","9015452",0,4,0,0,0,0
"13734","9015455",0,2,0,1,0,1
"13735","9015474",0,9,10,6,3,19
"13736","9015479",1,4,0,0,0,0
"13737","9015484",0,3,0,0,0,0
"13738","9015497",0,4,6,0,0,6
"13739","9015498",0,1,0,0,0,0
"13740","9015499",0,6,1,0,0,1
"13741","9015500",0,3,0,1,0,1
"13742","9015507",0,7,3,4,0,7
"13743","9015514",0,3,2,0,0,2
"13744","9015534",0,6,8,1,0,9
"13745","9015540",0,7,11,3,1,15
"13746","9015543",0,2,0,0,0,0
"13747","9015545",0,1,0,0,0,0
"13748","9015560",0,4,2,0,0,2
"13749","9015568",0,7,2,1,0,3
"13750","9015572",0,6,4,0,0,4
"13751","9015576",1,7,3,4,0,7
"13752","9015579",0,6,2,4,0,6
"13753","9015580",0,7,9,3,0,12
"13754","9015587",0,4,6,5,0,11
"13755","9015618",0,4,0,0,0,0
"13756","9015619",0,5,1,1,1,3
"13757","9015627",0,4,0,1,0,1
"13758","9015632",0,3,1,5,0,6
"13759","9015645",0,4,1,0,0,1
"13760","9015648",0,2,0,0,0,0
"13761","9015658",0,5,5,5,1,11
"13762","9015669",0,4,2,0,0,2
"13763","9015687",0,3,1,0,0,1
"13764","9015689",0,4,5,0,0,5
"13765","9015691",0,4,3,3,0,6
"13766","9015694",0,3,3,0,0,3
"13767","9015719",0,5,0,0,0,0
"13768","9015720",0,4,3,0,0,3
"13769","9015743",0,5,6,0,0,6
"13770","9015745",0,4,1,0,0,1
"13771","9015750",0,6,1,0,0,1
"13772","9015752",0,7,5,3,0,8
"13773","9015770",0,3,5,4,0,9
"13774","9015778",0,3,2,2,0,4
"13775","9015821",0,3,1,0,0,1
"13776","9015822",0,7,6,2,0,8
"13777","9015823",0,3,0,0,0,0
"13778","9015825",0,6,0,1,0,1
"13779","9015827",0,3,3,0,0,3
"13780","9015832",0,6,1,0,0,1
"13781","9015835",0,4,2,2,0,4
"13782","9015836",0,2,1,0,0,1
"13783","9015845",0,6,9,7,0,16
"13784","9015847",0,5,1,0,0,1
"13785","9015848",0,3,5,2,0,7
"13786","9015853",0,5,0,0,0,0
"13787","9015859",0,8,8,3,0,11
"13788","9015871",0,2,0,0,0,0
"13789","9015881",0,4,1,1,0,2
"13790","9015891",0,2,0,0,0,0
"13791","9015914",0,1,1,0,0,1
"13792","9015923",0,7,2,1,0,3
"13793","9015927",0,4,1,1,0,2
"13794","9015942",0,4,1,2,0,3
"13795","9015949",0,4,2,2,0,4
"13796","9015968",0,6,0,0,0,0
"13797","9015981",0,2,2,1,0,3
"13798","9015982",0,4,1,0,0,1
"13799","9015988",1,4,6,1,0,7
"13800","9015989",0,4,8,0,0,8
"13801","9015991",0,3,2,2,0,4
"13802","9015993",0,4,3,0,0,3
"13803","9015998",0,6,3,1,0,4
"13804","9016002",0,5,7,3,0,10
"13805","9016007",0,4,0,0,0,0
"13806","9016014",0,4,0,0,0,0
"13807","9016015",0,6,2,1,0,3
"13808","9016033",0,4,1,0,0,1
"13809","9016034",0,5,1,0,0,1
"13810","9016067",0,4,0,0,0,0
"13811","9016069",0,2,0,0,0,0
"13812","9016087",0,3,1,1,0,2
"13813","9016089",0,1,0,0,0,0
"13814","9016098",0,5,11,9,0,20
"13815","9016104",0,2,1,0,0,1
"13816","9016123",0,5,0,0,0,0
"13817","9016134",0,9,15,8,1,24
"13818","9016137",0,4,7,2,0,9
"13819","9016159",0,5,0,2,0,2
"13820","9016175",0,4,0,0,0,0
"13821","9016193",0,3,1,0,0,1
"13822","9016199",0,6,0,0,0,0
"13823","9016206",0,1,1,0,0,1
"13824","9016229",0,3,0,0,0,0
"13825","9016242",0,5,5,1,1,7
"13826","9016244",0,1,0,0,0,0
"13827","9016246",0,6,0,0,0,0
"13828","9016255",0,1,0,0,0,0
"13829","9016256",0,1,0,0,0,0
"13830","9016257",0,1,0,0,0,0
"13831","9016259",0,4,2,2,0,4
"13832","9016266",0,3,0,0,0,0
"13833","9016267",0,5,4,2,0,6
"13834","9016268",0,3,2,0,0,2
"13835","9016270",0,4,2,0,0,2
"13836","9016272",0,5,2,1,0,3
"13837","9016273",0,5,0,0,0,0
"13838","9016275",0,4,0,0,0,0
"13839","9016278",0,3,0,3,0,3
"13840","9016285",0,1,0,0,0,0
"13841","9016286",0,1,1,0,0,1
"13842","9016287",0,4,0,0,0,0
"13843","9016288",0,4,1,1,1,3
"13844","9016289",0,3,0,0,0,0
"13845","9016292",0,5,1,1,0,2
"13846","9016295",0,1,0,0,0,0
"13847","9016296",0,4,0,4,0,4
"13848","9016300",0,5,2,0,0,2
"13849","9016301",0,3,6,0,0,6
"13850","9016304",0,1,0,0,0,0
"13851","9016305",0,4,3,1,0,4
"13852","9016306",0,4,0,0,0,0
"13853","9016311",0,4,1,1,0,2
"13854","9016313",0,5,2,3,0,5
"13855","9016314",0,3,0,0,0,0
"13856","9016316",0,1,0,0,0,0
"13857","9016317",0,4,0,0,0,0
"13858","9016322",0,1,1,1,0,2
"13859","9016327",0,3,3,4,0,7
"13860","9016329",0,3,0,0,0,0
"13861","9016332",0,3,0,0,0,0
"13862","9016335",0,4,2,0,0,2
"13863","9016345",0,5,0,1,0,1
"13864","9016346",0,6,1,1,1,3
"13865","9016350",0,9,26,14,7,47
"13866","9016366",0,2,1,2,1,4
"13867","9016382",0,4,0,0,0,0
"13868","9016387",0,4,0,0,0,0
"13869","9016412",0,3,0,0,0,0
"13870","9016416",0,6,0,0,0,0
"13871","9016422",0,1,1,0,0,1
"13872","9016423",0,3,0,0,0,0
"13873","9016447",0,4,5,0,0,5
"13874","9016448",0,5,0,1,0,1
"13875","9016461",0,5,7,0,1,8
"13876","9016463",0,7,0,5,1,6
"13877","9016464",0,1,0,0,0,0
"13878","9016466",0,1,0,0,0,0
"13879","9016468",0,5,3,0,1,4
"13880","9016469",0,3,0,0,0,0
"13881","9016496",0,3,6,2,0,8
"13882","9016524",0,1,1,0,0,1
"13883","9016526",1,1,0,0,0,0
"13884","9016534",0,4,0,0,0,0
"13885","9016547",0,3,2,4,1,7
"13886","9016549",0,2,0,0,0,0
"13887","9016551",0,1,1,0,0,1
"13888","9016552",0,5,2,0,0,2
"13889","9016555",0,2,1,1,0,2
"13890","9016559",0,1,2,1,0,3
"13891","9016566",0,1,0,0,0,0
"13892","9016586",0,1,0,0,0,0
"13893","9016612",0,4,5,1,0,6
"13894","9016617",0,8,5,9,5,19
"13895","9016622",0,5,0,0,0,0
"13896","9016630",0,2,4,3,0,7
"13897","9016652",0,9,13,7,5,25
"13898","9016653",0,3,4,0,0,4
"13899","9016657",0,4,3,2,0,5
"13900","9016659",0,4,0,0,0,0
"13901","9016668",0,1,0,0,0,0
"13902","9016680",0,8,8,3,1,12
"13903","9016707",0,3,2,2,0,4
"13904","9016720",0,1,1,0,0,1
"13905","9016725",0,4,1,0,0,1
"13906","9016728",0,3,4,0,0,4
"13907","9016730",0,4,0,0,0,0
"13908","9016748",0,4,2,1,0,3
"13909","9016759",0,4,5,1,0,6
"13910","9016767",0,4,3,4,0,7
"13911","9016773",0,3,1,3,0,4
"13912","9016782",0,5,7,3,1,11
"13913","9016784",0,1,1,0,0,1
"13914","9016790",0,3,0,0,0,0
"13915","9016791",0,1,0,0,0,0
"13916","9016792",0,4,0,0,0,0
"13917","9016794",0,3,2,0,0,2
"13918","9016798",0,3,5,0,1,6
"13919","9016805",0,3,0,0,0,0
"13920","9016811",0,1,0,0,0,0
"13921","9016827",0,3,1,0,0,1
"13922","9016832",0,4,1,0,0,1
"13923","9016849",0,5,1,0,0,1
"13924","9016857",0,5,5,0,0,5
"13925","9016858",0,1,0,0,0,0
"13926","9016861",0,4,0,0,0,0
"13927","9016868",0,2,3,3,0,6
"13928","9016872",0,5,6,2,0,8
"13929","9016884",0,3,0,0,0,0
"13930","9016887",0,2,1,0,0,1
"13931","9016889",0,4,0,0,0,0
"13932","9016890",0,4,0,0,0,0
"13933","9016898",0,7,7,12,0,19
"13934","9016901",0,2,0,0,0,0
"13935","9016913",0,1,0,0,0,0
"13936","9016925",0,4,6,1,0,7
"13937","9016931",0,5,0,1,0,1
"13938","9016940",0,3,1,0,0,1
"13939","9016942",0,4,0,0,0,0
"13940","9016950",0,6,1,1,0,2
"13941","9016953",0,6,7,5,0,12
"13942","9016968",0,2,0,0,0,0
"13943","9016993",0,1,1,1,0,2
"13944","9016995",0,1,0,0,0,0
"13945","9016997",0,4,2,0,0,2
"13946","9017010",0,2,0,0,0,0
"13947","9017026",0,1,0,0,0,0
"13948","9017037",0,5,2,0,0,2
"13949","9017039",0,5,3,1,0,4
"13950","9017040",0,3,8,1,0,9
"13951","9017041",0,3,0,0,0,0
"13952","9017049",0,1,0,0,0,0
"13953","9017052",0,4,5,1,0,6
"13954","9017059",0,7,4,8,0,12
"13955","9017076",0,4,0,0,0,0
"13956","9017088",0,3,4,0,0,4
"13957","9017108",0,4,0,0,0,0
"13958","9017145",0,5,1,0,0,1
"13959","9017159",0,2,0,0,0,0
"13960","9017164",0,1,1,0,0,1
"13961","9017165",0,5,2,1,0,3
"13962","9017169",0,1,1,0,0,1
"13963","9017185",0,6,9,5,1,15
"13964","9017186",0,4,0,0,0,0
"13965","9017203",0,4,5,8,0,13
"13966","9017207",0,3,0,0,0,0
"13967","9017208",0,2,1,0,0,1
"13968","9017235",0,4,0,1,0,1
"13969","9017238",0,4,3,1,0,4
"13970","9017263",0,9,6,15,1,22
"13971","9017279",0,2,0,0,0,0
"13972","9017280",0,5,3,2,0,5
"13973","9017284",0,4,0,0,0,0
"13974","9017293",0,3,3,2,0,5
"13975","9017297",0,3,0,0,0,0
"13976","9017298",0,4,1,0,0,1
"13977","9017299",0,7,1,3,0,4
"13978","9017311",0,1,0,0,0,0
"13979","9017313",0,8,16,4,0,20
"13980","9017314",0,6,2,0,0,2
"13981","9017324",1,7,1,1,0,2
"13982","9017325",0,3,0,0,0,0
"13983","9017333",0,2,0,0,0,0
"13984","9017337",0,2,0,0,0,0
"13985","9017342",0,5,5,1,0,6
"13986","9017348",0,2,0,0,0,0
"13987","9017359",0,4,5,1,0,6
"13988","9017365",0,3,0,0,0,0
"13989","9017366",0,3,0,0,0,0
"13990","9017369",0,4,0,0,0,0
"13991","9017373",0,5,15,1,0,16
"13992","9017375",0,4,0,0,0,0
"13993","9017376",0,2,0,0,0,0
"13994","9017389",0,4,6,1,0,7
"13995","9017397",0,1,0,0,0,0
"13996","9017400",0,6,2,1,0,3
"13997","9017401",0,3,0,1,0,1
"13998","9017432",0,2,0,0,0,0
"13999","9017446",0,1,1,0,0,1
"14000","9017447",0,1,0,0,0,0
"14001","9017457",0,4,0,1,0,1
"14002","9017466",0,7,9,4,2,15
"14003","9017471",0,8,13,4,1,18
"14004","9017486",0,8,7,2,0,9
"14005","9017491",0,5,1,2,0,3
"14006","9017494",0,4,1,0,0,1
"14007","9017497",0,4,0,0,0,0
"14008","9017503",0,5,1,0,0,1
"14009","9017505",0,4,2,0,0,2
"14010","9017508",0,4,0,0,0,0
"14011","9017518",0,1,0,2,0,2
"14012","9017520",0,2,0,0,0,0
"14013","9017526",0,6,0,0,0,0
"14014","9017533",0,1,0,0,0,0
"14015","9017534",0,1,0,0,0,0
"14016","9017539",0,4,6,3,0,9
"14017","9017552",0,3,0,0,0,0
"14018","9017560",0,7,9,9,0,18
"14019","9017562",0,6,6,8,1,15
"14020","9017570",0,5,2,3,0,5
"14021","9017605",0,3,0,1,0,1
"14022","9017613",0,1,0,0,0,0
"14023","9017624",0,3,6,0,0,6
"14024","9017631",0,1,0,0,0,0
"14025","9017640",0,1,0,0,0,0
"14026","9017642",0,1,1,0,0,1
"14027","9017645",0,4,0,0,0,0
"14028","9017646",0,1,0,0,0,0
"14029","9017671",0,4,2,1,0,3
"14030","9017674",0,1,0,0,0,0
"14031","9017688",0,4,1,0,0,1
"14032","9017689",0,3,2,1,0,3
"14033","9017704",0,5,2,4,0,6
"14034","9017705",0,9,12,8,2,22
"14035","9017721",0,1,0,0,0,0
"14036","9017731",0,5,0,1,0,1
"14037","9017732",0,1,0,0,0,0
"14038","9017741",0,9,17,16,4,37
"14039","9017750",0,4,0,0,0,0
"14040","9017755",0,5,0,1,0,1
"14041","9017758",0,4,3,3,0,6
"14042","9017778",0,3,3,1,0,4
"14043","9017779",0,4,0,1,0,1
"14044","9017781",0,3,0,0,0,0
"14045","9017784",0,5,1,3,0,4
"14046","9017801",0,7,8,4,1,13
"14047","9017828",0,5,0,0,0,0
"14048","9017829",0,4,0,0,0,0
"14049","9017833",0,7,0,2,0,2
"14050","9017835",0,1,0,0,0,0
"14051","9017843",0,5,1,0,0,1
"14052","9017849",0,4,3,1,1,5
"14053","9017858",0,4,2,0,0,2
"14054","9017860",0,5,6,0,0,6
"14055","9017867",0,2,0,0,0,0
"14056","9017871",0,1,0,0,0,0
"14057","9017872",0,2,1,1,0,2
"14058","9017873",0,6,0,0,0,0
"14059","9017894",0,4,0,0,0,0
"14060","9017919",0,6,7,5,0,12
"14061","9017920",0,1,0,0,0,0
"14062","9017924",0,7,15,4,0,19
"14063","9017933",0,1,0,0,0,0
"14064","9017937",0,3,3,0,0,3
"14065","9017943",0,1,0,0,0,0
"14066","9017944",0,4,6,2,0,8
"14067","9017950",0,4,2,1,0,3
"14068","9017954",0,2,3,4,0,7
"14069","9018012",0,5,0,1,0,1
"14070","9018017",0,2,2,0,0,2
"14071","9018022",0,11,9,10,6,25
"14072","9018116",0,3,2,1,0,3
"14073","9018358",0,3,0,0,0,0
"14074","9018423",0,3,1,0,0,1
"14075","9018436",0,2,1,1,0,2
"14076","9018442",0,5,1,6,0,7
"14077","9018443",0,5,0,0,0,0
"14078","9018449",0,4,1,2,0,3
"14079","9018452",0,1,1,0,0,1
"14080","9018461",0,2,5,1,0,6
"14081","9018473",0,4,1,0,0,1
"14082","9018474",0,1,0,0,0,0
"14083","9018485",0,5,0,1,0,1
"14084","9018488",0,5,1,2,0,3
"14085","9018537",0,3,0,0,0,0
"14086","9018543",0,4,0,1,2,3
"14087","9018552",0,4,0,0,0,0
"14088","9018575",0,4,3,1,0,4
"14089","9018579",0,4,0,0,0,0
"14090","9018585",0,4,0,0,0,0
"14091","9018592",0,13,15,19,5,39
"14092","9018664",0,2,0,0,0,0
"14093","9018686",0,7,9,9,0,18
"14094","9018712",0,8,13,4,3,20
"14095","9018774",0,3,4,0,0,4
"14096","9018788",0,3,2,1,0,3
"14097","9018799",0,5,2,1,0,3
"14098","9018882",0,5,1,2,0,3
"14099","9018887",0,4,2,1,0,3
"14100","9018891",0,5,2,1,0,3
"14101","9018911",0,4,1,0,0,1
"14102","9018941",0,4,5,1,0,6
"14103","9018951",0,5,2,0,0,2
"14104","9018979",0,1,0,0,0,0
"14105","9019010",0,4,2,1,0,3
"14106","9019011",0,7,7,7,0,14
"14107","9019023",0,6,5,8,0,13
"14108","9019026",0,3,1,0,0,1
"14109","9019069",0,4,1,0,0,1
"14110","9019072",0,4,0,0,0,0
"14111","9019089",0,6,8,8,1,17
"14112","9019095",0,1,1,0,0,1
"14113","9019116",0,4,2,0,0,2
"14114","9019122",0,3,1,0,0,1
"14115","9019123",0,4,1,0,0,1
"14116","9019144",0,2,0,0,0,0
"14117","9019147",0,1,0,0,0,0
"14118","9019165",0,5,3,0,1,4
"14119","9019196",0,3,5,2,0,7
"14120","9019246",0,3,4,2,0,6
"14121","9019250",0,5,2,0,0,2
"14122","9019275",0,5,9,6,1,16
"14123","9019290",0,3,1,1,0,2
"14124","9020370",0,2,0,0,0,0
"14125","9020386",0,2,0,2,0,2
"14126","9020398",0,4,0,0,0,0
"14127","9020443",0,3,1,0,0,1
"14128","9020460",0,3,0,0,0,0
"14129","9020463",0,7,7,4,0,11
"14130","9020468",0,4,5,2,0,7
"14131","9020479",0,4,2,2,0,4
"14132","9020532",0,5,10,3,0,13
"14133","9020556",0,4,0,0,0,0
"14134","9020600",0,6,6,4,2,12
"14135","9020630",0,5,2,1,0,3
"14136","9020642",0,5,0,0,0,0
"14137","9020643",0,7,6,0,0,6
"14138","9020672",0,3,0,1,0,1
"14139","9020683",0,4,3,1,0,4
"14140","9020692",0,6,1,0,0,1
"14141","9020700",0,4,5,0,0,5
"14142","9020740",0,2,0,0,0,0
"14143","9020763",0,5,1,4,0,5
"14144","9020800",0,4,0,0,0,0
"14145","9020855",0,5,5,1,0,6
"14146","9020914",0,6,1,2,0,3
"14147","9020921",0,1,0,0,0,0
"14148","9020942",0,6,3,4,0,7
"14149","9020970",0,1,0,0,0,0
"14150","9020972",0,7,9,10,0,19
"14151","9020992",0,3,1,0,0,1
"14152","9021003",0,4,0,1,0,1
"14153","9021007",0,4,0,0,0,0
"14154","9021023",0,4,1,0,0,1
"14155","9021031",0,4,4,0,0,4
"14156","9021036",0,4,0,0,0,0
"14157","9021037",0,5,5,2,0,7
"14158","9021059",0,3,2,0,0,2
"14159","9021061",0,2,0,0,0,0
"14160","9021124",0,3,2,1,0,3
"14161","9021137",0,2,0,0,0,0
"14162","9021151",0,3,0,0,0,0
"14163","9021159",0,5,4,3,0,7
"14164","9021186",0,6,0,0,0,0
"14165","9021201",0,3,3,1,0,4
"14166","9021221",0,4,3,0,0,3
"14167","9021336",0,3,0,0,0,0
"14168","9021383",0,4,1,0,0,1
"14169","9021529",0,1,0,0,0,0
"14170","9021603",0,3,2,1,0,3
"14171","9021686",0,3,0,0,0,0
"14172","9021687",0,10,11,10,1,22
"14173","9021768",0,5,0,1,0,1
"14174","9021803",0,3,0,0,0,0
"14175","9021822",0,6,2,3,0,5
"14176","9021935",0,7,1,0,0,1
"14177","9021955",0,3,3,0,0,3
"14178","9021965",0,6,9,11,0,20
"14179","9022002",0,5,7,6,0,13
"14180","9022070",0,3,1,0,0,1
"14181","9022105",0,4,0,0,0,0
"14182","9022118",0,5,1,2,0,3
"14183","9022123",0,7,5,2,1,8
"14184","9022124",0,8,2,4,0,6
"14185","9022145",0,4,1,1,0,2
"14186","9022189",0,6,0,0,0,0
"14187","9022205",0,7,4,5,2,11
"14188","9022235",0,7,1,0,0,1
"14189","9022267",0,4,0,0,0,0
"14190","9022303",0,3,3,3,0,6
"14191","9022310",0,2,0,0,0,0
"14192","9022377",0,5,5,4,2,11
"14193","9022431",0,6,3,5,0,8
"14194","9022480",0,7,5,3,2,10
"14195","9022541",0,1,1,0,0,1
"14196","9022544",0,2,1,0,0,1
"14197","9022551",0,5,4,1,0,5
"14198","9022582",1,6,4,5,0,9
"14199","9022601",0,3,0,3,0,3
"14200","9022657",0,1,0,0,0,0
"14201","9022678",0,3,0,1,0,1
"14202","9022696",0,1,1,0,0,1
"14203","9022718",0,2,0,0,0,0
"14204","9022745",0,3,0,0,0,0
"14205","9022747",0,1,0,0,0,0
"14206","9022793",0,2,0,0,0,0
"14207","9022795",0,2,0,1,0,1
"14208","9022797",0,4,0,0,0,0
"14209","9022803",0,3,0,0,0,0
"14210","9022828",0,4,5,0,0,5
"14211","9022866",0,4,1,0,0,1
"14212","9022901",0,2,0,0,0,0
"14213","9022902",0,2,0,0,0,0
"14214","9022925",0,6,5,2,0,7
"14215","9022993",0,1,0,2,0,2
"14216","9023026",0,6,6,9,0,15
"14217","9023068",1,4,0,1,0,1
"14218","9023084",0,3,0,1,0,1
"14219","9023107",0,6,1,4,1,6
"14220","9023201",0,2,0,0,0,0
"14221","9023248",0,6,16,2,0,18
"14222","9023251",0,2,3,0,0,3
"14223","9023260",0,6,1,2,0,3
"14224","9023267",0,1,0,0,0,0
"14225","9023442",0,4,1,0,0,1
"14226","9023454",0,2,1,0,0,1
"14227","9023562",0,3,0,0,0,0
"14228","9023580",0,5,5,1,0,6
"14229","9023755",0,4,2,2,0,4
"14230","9023778",0,2,0,0,0,0
"14231","9023810",0,1,0,0,0,0
"14232","9023900",0,7,5,3,0,8
"14233","9023903",0,5,5,1,0,6
"14234","9024000",0,6,7,2,0,9
"14235","9024024",0,6,2,5,0,7
"14236","9024028",1,1,0,0,0,0
"14237","9024081",0,4,1,0,0,1
"14238","9024108",0,3,1,0,0,1
"14239","9024121",0,2,1,1,0,2
"14240","9024153",0,6,1,0,0,1
"14241","9024189",0,4,0,0,0,0
"14242","9024196",0,2,2,1,0,3
"14243","9024219",0,4,1,0,0,1
"14244","9024317",0,2,1,0,0,1
"14245","9024365",0,8,13,2,2,17
"14246","9024382",0,3,0,0,0,0
"14247","9024454",0,7,5,11,2,18
"14248","9028999",1,4,0,0,0,0
"14249","9029025",0,6,11,5,2,18
"14250","9029100",0,4,4,1,0,5
"14251","9029114",0,4,0,0,0,0
"14252","9029138",0,5,9,3,0,12
"14253","9029170",0,4,1,2,0,3
"14254","9029198",0,4,11,1,1,13
"14255","9029217",0,3,2,0,0,2
"14256","9029308",0,2,5,2,0,7
"14257","9029336",0,1,0,0,0,0
"14258","9029341",0,1,1,0,0,1
"14259","9029360",0,4,3,0,0,3
"14260","9029364",0,2,0,0,0,0
"14261","9029440",0,4,0,0,0,0
"14262","9029472",0,1,0,0,0,0
"14263","9029478",0,1,1,0,0,1
"14264","9029487",0,2,1,0,0,1
"14265","9029544",0,3,0,0,0,0
"14266","9029558",0,2,0,0,0,0
"14267","9029812",0,2,0,0,0,0
"14268","9029885",0,3,0,0,0,0
"14269","9030033",0,6,2,4,0,6
"14270","9030053",0,4,1,0,0,1
"14271","9030072",0,3,0,1,0,1
"14272","9030095",0,4,2,0,0,2
"14273","9030138",0,5,6,0,1,7
"14274","9030195",0,4,0,1,0,1
"14275","9030218",0,4,2,1,0,3
"14276","9030249",0,4,2,0,0,2
"14277","9030251",0,4,2,0,0,2
"14278","9030261",0,4,1,0,0,1
"14279","9030263",0,3,3,1,0,4
"14280","9030265",0,2,0,0,0,0
"14281","9030360",0,4,0,0,0,0
"14282","9030361",0,4,0,0,0,0
"14283","9030393",0,4,0,0,0,0
"14284","9030457",0,3,2,0,0,2
"14285","9030462",0,4,0,0,0,0
"14286","9030531",0,6,8,4,0,12
"14287","9030548",0,6,8,2,0,10
"14288","9030570",0,3,0,0,0,0
"14289","9030619",0,4,0,1,0,1
"14290","9030620",0,4,1,2,0,3
"14291","9030621",0,4,2,3,0,5
"14292","9030622",0,4,1,2,0,3
"14293","9030623",0,5,1,0,0,1
"14294","9030638",0,1,0,0,0,0
"14295","9030640",0,5,1,0,0,1
"14296","9030708",0,1,0,0,0,0
"14297","9030789",0,5,1,0,0,1
"14298","9030842",0,4,0,0,0,0
"14299","9030919",0,3,3,0,0,3
"14300","9030959",0,5,1,1,0,2
"14301","9031069",0,3,0,1,0,1
"14302","9031080",0,4,0,0,0,0
"14303","9031081",1,6,8,7,3,18
"14304","9031104",0,4,2,1,0,3
"14305","9031117",0,3,3,0,0,3
"14306","9031124",0,2,0,0,0,0
"14307","9031125",0,1,0,0,0,0
"14308","9031126",0,1,0,0,0,0
"14309","9031160",0,2,0,0,0,0
"14310","9031161",0,2,4,0,0,4
"14311","9031162",0,2,0,0,0,0
"14312","9031163",0,3,0,0,0,0
"14313","9031222",0,5,4,3,0,7
"14314","9031374",0,4,3,0,0,3
"14315","9031375",0,3,0,0,0,0
"14316","9031385",0,2,0,0,0,0
"14317","9031410",0,4,0,0,0,0
"14318","9031528",0,5,0,0,0,0
"14319","9031537",0,7,3,4,0,7
"14320","9031595",0,4,2,0,0,2
"14321","9031675",0,3,0,0,0,0
"14322","9031690",0,5,3,4,0,7
"14323","9031693",0,1,0,0,0,0
"14324","9031703",0,4,1,0,0,1
"14325","9031750",0,4,6,1,0,7
"14326","9031774",0,6,2,3,0,5
"14327","9031808",0,5,2,0,0,2
"14328","9031894",0,3,0,0,0,0
"14329","9031897",0,4,0,0,0,0
"14330","9031951",0,4,0,0,0,0
"14331","9031964",0,3,0,0,0,0
"14332","9031980",0,4,2,0,0,2
"14333","9031988",0,4,0,0,0,0
"14334","9032089",0,4,0,3,0,3
"14335","9032132",0,1,3,1,0,4
"14336","9032159",0,2,0,0,0,0
"14337","9032237",0,3,0,0,0,0
"14338","9032240",0,4,0,0,0,0
"14339","9032314",0,4,4,4,0,8
"14340","9032323",0,2,0,0,0,0
"14341","9032387",0,4,5,1,0,6
"14342","9032392",0,2,0,0,0,0
"14343","9032401",0,4,1,1,0,2
"14344","9032433",0,3,1,0,0,1
"14345","9032456",0,6,0,0,0,0
"14346","9032476",0,4,0,0,0,0
"14347","9032477",0,2,0,0,0,0
"14348","9032552",0,5,0,0,0,0
"14349","9032688",0,2,3,1,0,4
"14350","9032755",0,3,2,0,0,2
"14351","9032853",0,3,0,0,0,0
"14352","9032872",0,2,0,0,0,0
"14353","9032885",0,1,0,0,0,0
"14354","9032935",0,4,0,1,0,1
"14355","9041731",0,4,1,3,0,4
"14356","9041768",0,6,5,5,0,10
"14357","9041814",0,5,2,0,0,2
"14358","9041825",0,7,7,4,0,11
"14359","9041947",0,12,8,17,8,33
"14360","9041958",0,4,2,2,1,5
"14361","9041959",0,5,0,1,0,1
"14362","9041968",0,5,0,1,0,1
"14363","9041980",0,7,0,3,0,3
"14364","9042190",0,4,0,0,0,0
"14365","9042230",0,4,0,2,1,3
"14366","9042594",0,5,1,0,0,1
"14367","9042614",0,1,0,0,0,0
"14368","9042935",0,5,0,0,0,0
"14369","9042956",0,4,0,0,0,0
"14370","9042979",0,5,5,3,0,8
"14371","9043220",0,1,0,0,0,0
"14372","9043303",0,6,2,2,0,4
"14373","9043397",0,4,4,1,0,5
"14374","9043530",0,4,2,0,0,2
"14375","9043536",0,2,0,0,0,0
"14376","9043539",0,8,3,4,0,7
"14377","9043672",0,6,1,1,0,2
"14378","9043728",0,4,0,0,0,0
"14379","9043760",0,3,1,0,0,1
"14380","9043776",0,5,0,0,0,0
"14381","9043821",0,2,5,0,0,5
"14382","9043901",0,4,0,1,0,1
"14383","9044040",0,4,1,1,0,2
"14384","9044090",0,6,3,1,0,4
"14385","9044191",0,4,2,2,0,4
"14386","9044241",0,4,0,0,0,0
"14387","9044284",0,2,3,0,0,3
"14388","9044287",0,3,0,1,0,1
"14389","9044487",0,3,0,0,0,0
"14390","9044516",0,4,4,1,0,5
"14391","9044630",0,4,3,2,1,6
"14392","9044689",0,2,0,0,0,0
"14393","9044765",0,5,2,0,0,2
"14394","9044789",0,4,0,0,0,0
"14395","9044903",0,4,0,1,0,1
"14396","9044937",0,4,3,0,0,3
"14397","9044964",0,3,0,3,0,3
"14398","9045081",0,5,3,2,0,5
"14399","9045102",0,4,3,2,0,5
"14400","9045105",0,4,1,2,0,3
"14401","9045176",0,1,0,0,0,0
"14402","9045209",0,3,2,0,0,2
"14403","9045248",0,8,13,8,1,22
"14404","9045289",0,4,3,1,0,4
"14405","9045334",0,4,0,0,0,0
"14406","9045349",0,1,0,0,0,0
"14407","9045501",0,5,1,0,0,1
"14408","9045566",0,3,7,4,0,11
"14409","9045608",0,5,7,4,0,11
"14410","9045623",0,7,1,0,0,1
"14411","9045625",0,5,0,0,0,0
"14412","9045732",0,3,1,0,0,1
"14413","9045743",0,4,2,1,0,3
"14414","9045918",0,1,0,1,0,1
"14415","9045921",0,2,0,1,0,1
"14416","9045959",0,1,0,0,0,0
"14417","9045993",0,4,0,0,0,0
"14418","9046054",0,3,0,0,0,0
"14419","9046101",0,2,2,1,0,3
"14420","9046133",0,5,1,3,2,6
"14421","9046182",0,4,0,0,0,0
"14422","9046374",1,2,0,0,0,0
"14423","9046403",0,2,0,0,0,0
"14424","9046405",0,3,2,0,0,2
"14425","9046445",0,4,0,0,0,0
"14426","9046636",0,2,2,0,0,2
"14427","9046714",0,6,13,5,1,19
"14428","9046771",0,2,0,0,0,0
"14429","9047156",0,3,6,1,0,7
"14430","9047409",0,8,21,10,0,31
"14431","9047478",0,7,17,5,0,22
"14432","9047608",0,3,1,2,0,3
"14433","9047809",0,1,0,1,0,1
"14434","9047834",0,8,6,15,1,22
"14435","9047912",0,5,2,1,0,3
"14436","9048075",0,2,0,0,0,0
"14437","9048089",0,4,0,0,0,0
"14438","9048382",0,4,1,1,0,2
"14439","9048591",0,1,0,0,0,0
"14440","9048593",0,6,1,2,0,3
"14441","9048627",0,1,0,0,0,0
"14442","9048736",0,2,1,0,0,1
"14443","9049182",0,5,2,0,0,2
"14444","9049395",0,6,1,2,0,3
"14445","9049436",0,3,4,2,0,6
"14446","9049437",0,5,8,2,0,10
"14447","9049488",0,3,2,1,0,3
"14448","9049513",0,1,0,0,0,0
"14449","9049680",0,3,0,2,0,2
"14450","9049711",0,4,2,0,0,2
"14451","9049782",0,5,0,0,0,0
"14452","9049786",0,2,0,0,0,0
"14453","9049809",0,3,0,0,0,0
"14454","9049963",0,3,6,4,0,10
"14455","9050163",0,9,9,3,0,12
"14456","9050251",0,5,1,0,0,1
"14457","9050252",0,8,1,4,1,6
"14458","9050254",0,6,1,0,0,1
"14459","9050255",0,5,0,0,0,0
"14460","9050266",0,1,0,0,0,0
"14461","9050327",0,2,3,1,0,4
"14462","9050379",0,5,2,2,0,4
"14463","9050411",0,1,0,0,0,0
"14464","9050725",0,4,1,0,0,1
"14465","9050780",0,1,1,0,0,1
"14466","9050818",0,3,0,0,0,0
"14467","9050820",0,6,3,1,0,4
"14468","9050863",0,7,8,5,1,14
"14469","9051018",0,4,0,0,0,0
"14470","9051183",0,7,7,4,0,11
"14471","9051190",0,10,7,6,0,13
"14472","9051216",0,7,11,3,1,15
"14473","9051308",0,4,7,1,0,8
"14474","9051352",0,4,4,1,0,5
"14475","9051353",0,5,3,6,0,9
"14476","9051480",0,4,4,6,1,11
"14477","9051495",0,7,3,1,0,4
"14478","9051600",0,3,0,1,0,1
"14479","9051620",0,2,1,0,0,1
"14480","9051640",0,5,1,2,0,3
"14481","9051693",0,4,0,1,0,1
"14482","9051701",0,7,9,5,0,14
"14483","9051936",0,2,0,0,0,0
"14484","9051963",0,4,0,0,0,0
"14485","9051965",0,3,0,1,0,1
"14486","9052008",0,6,10,4,0,14
"14487","9052011",0,4,0,4,1,5
"14488","9052113",0,4,1,0,0,1
"14489","9052159",0,4,0,0,0,0
"14490","9052170",0,5,0,0,0,0
"14491","9052251",0,3,0,0,0,0
"14492","9052265",0,8,15,3,1,19
"14493","9052300",0,3,3,1,0,4
"14494","9052322",0,4,7,1,0,8
"14495","9052369",0,6,9,4,0,13
"14496","9052471",0,6,1,0,0,1
"14497","9052658",0,1,0,0,0,0
"14498","9052660",0,5,3,1,0,4
"14499","9052694",0,4,0,0,0,0
"14500","9052723",0,3,6,8,0,14
"14501","9052820",0,6,8,2,0,10
"14502","9052834",0,4,0,3,0,3
"14503","9052866",0,1,0,0,0,0
"14504","9052873",0,5,8,3,0,11
"14505","9052884",0,2,0,0,0,0
"14506","9053084",0,5,4,11,1,16
"14507","9053124",0,5,0,0,0,0
"14508","9053174",0,2,0,0,0,0
"14509","9053211",0,3,7,0,0,7
"14510","9053239",0,3,0,1,0,1
"14511","9053240",0,4,4,0,0,4
"14512","9053289",0,3,3,0,0,3
"14513","9053322",0,6,2,0,0,2
"14514","9053330",0,4,0,0,0,0
"14515","9053355",0,9,13,0,1,14
"14516","9053407",0,2,3,0,0,3
"14517","9053416",0,4,2,0,0,2
"14518","9053417",0,2,0,0,0,0
"14519","9053467",0,1,0,0,0,0
"14520","9053490",0,1,0,0,0,0
"14521","9053498",0,6,0,0,0,0
"14522","9053500",0,1,0,0,0,0
"14523","9053501",0,4,1,0,0,1
"14524","9053506",0,2,0,1,0,1
"14525","9053507",0,2,0,0,0,0
"14526","9053509",0,2,0,1,0,1
"14527","9053706",0,5,4,0,0,4
"14528","9053714",0,5,1,1,0,2
"14529","9053762",0,4,1,3,0,4
"14530","9053772",0,2,0,0,0,0
"14531","9053780",0,5,5,3,0,8
"14532","9053839",1,2,3,0,0,3
"14533","9053861",0,5,4,3,0,7
"14534","9053901",0,6,8,6,0,14
"14535","9053961",0,3,1,1,0,2
"14536","9053966",0,4,0,1,0,1
"14537","9053975",0,4,0,0,0,0
"14538","9054043",0,4,0,0,0,0
"14539","9054055",0,5,4,0,1,5
"14540","9054074",0,2,0,1,0,1
"14541","9054079",0,5,6,2,0,8
"14542","9054190",0,4,0,0,0,0
"14543","9054246",0,5,4,3,0,7
"14544","9054278",0,1,0,0,0,0
"14545","9054295",0,2,0,1,0,1
"14546","9054550",0,4,0,1,0,1
"14547","9054690",0,4,2,0,0,2
"14548","9054784",0,1,0,0,0,0
"14549","9054915",0,5,2,2,0,4
"14550","9054940",0,4,3,1,0,4
"14551","9054970",0,4,4,0,0,4
"14552","9055033",0,5,3,1,0,4
"14553","9055148",0,3,3,0,0,3
"14554","9055236",0,1,0,0,0,0
"14555","9055243",0,4,3,1,0,4
"14556","9055302",0,4,1,2,0,3
"14557","9055371",0,4,2,0,0,2
"14558","9055438",0,3,0,1,0,1
"14559","9055455",0,1,1,0,0,1
"14560","9055482",0,8,7,15,0,22
"14561","9055567",0,4,0,0,0,0
"14562","9055705",0,3,1,1,0,2
"14563","9055755",0,5,0,0,0,0
"14564","9055771",0,2,0,0,0,0
"14565","9055796",0,3,7,1,0,8
"14566","9055809",0,4,2,1,0,3
"14567","9055854",0,1,1,0,0,1
"14568","9055859",0,1,1,0,0,1
"14569","9055953",0,1,0,0,0,0
"14570","9056058",0,8,7,8,0,15
"14571","9056085",0,6,7,0,0,7
"14572","9056140",0,5,0,0,0,0
"14573","9056166",0,4,6,2,0,8
"14574","9056353",0,2,0,0,0,0
"14575","9056473",0,1,1,0,0,1
"14576","9056538",0,3,0,0,0,0
"14577","9056549",0,2,0,0,0,0
"14578","9056687",0,3,0,2,0,2
"14579","9056735",0,4,1,0,0,1
"14580","9056782",0,3,8,2,0,10
"14581","9056877",1,9,9,5,1,15
"14582","9056915",0,1,0,0,0,0
"14583","9056917",0,3,1,0,0,1
"14584","9056927",0,1,2,1,0,3
"14585","9056983",0,3,4,0,0,4
"14586","9056998",0,2,0,0,0,0
"14587","9057000",0,5,4,8,2,14
"14588","9057015",0,3,7,4,0,11
"14589","9057086",0,5,1,0,0,1
"14590","9057113",0,4,0,0,0,0
"14591","9057133",0,6,3,1,0,4
"14592","9057272",0,2,1,0,0,1
"14593","9057485",0,2,0,0,0,0
"14594","9057500",0,5,3,1,0,4
"14595","9057507",0,5,4,1,0,5
"14596","9057508",0,4,1,0,0,1
"14597","9057580",0,1,0,0,0,0
"14598","9057581",0,2,1,0,0,1
"14599","9057582",0,2,0,0,0,0
"14600","9057584",0,4,1,2,0,3
"14601","9057592",0,6,1,3,1,5
"14602","9057596",0,2,0,0,0,0
"14603","9057598",0,6,1,3,2,6
"14604","9057599",0,4,1,2,0,3
"14605","9057601",0,2,1,0,0,1
"14606","9057659",0,2,1,0,0,1
"14607","9057660",0,5,6,2,0,8
"14608","9057697",0,4,2,1,0,3
"14609","9057698",0,4,1,2,0,3
"14610","9057706",0,4,0,1,0,1
"14611","9057719",0,2,0,0,0,0
"14612","9057837",0,1,0,0,0,0
"14613","9057919",0,2,0,0,0,0
"14614","9057925",0,3,0,0,0,0
"14615","9057926",0,2,0,1,0,1
"14616","9057927",0,1,0,0,0,0
"14617","9057968",0,6,1,1,0,2
"14618","9057995",0,5,1,3,1,5
"14619","9058009",0,3,2,0,0,2
"14620","9058032",0,3,0,0,0,0
"14621","9058040",0,1,0,0,0,0
"14622","9058047",0,4,0,0,0,0
"14623","9058095",0,4,8,3,1,12
"14624","9058198",0,5,3,0,0,3
"14625","9058244",0,7,10,3,1,14
"14626","9058421",0,2,0,0,0,0
"14627","9058436",0,3,0,0,0,0
"14628","9058441",0,5,8,0,0,8
"14629","9058458",0,4,4,0,0,4
"14630","9058489",0,3,0,1,0,1
"14631","9058490",0,4,0,0,0,0
"14632","9058492",0,2,0,0,0,0
"14633","9058494",0,4,0,0,0,0
"14634","9058498",0,1,0,0,0,0
"14635","9058503",0,3,0,0,0,0
"14636","9058508",0,4,0,3,0,3
"14637","9058515",0,4,0,0,0,0
"14638","9058517",0,4,0,1,0,1
"14639","9058522",0,3,0,3,0,3
"14640","9058527",0,3,0,1,0,1
"14641","9058528",0,4,0,0,0,0
"14642","9058531",0,4,0,3,0,3
"14643","9058648",0,6,13,4,1,18
"14644","9058772",0,3,7,3,0,10
"14645","9058782",0,4,0,2,0,2
"14646","9058795",0,2,0,0,0,0
"14647","9058853",1,6,2,0,0,2
"14648","9058936",0,2,0,0,0,0
"14649","9058962",1,4,0,0,0,0
"14650","9059151",0,7,0,0,0,0
"14651","9059195",0,4,0,0,0,0
"14652","9059225",0,3,2,0,0,2
"14653","9059234",0,6,5,1,0,6
"14654","9059312",0,3,1,2,0,3
"14655","9059365",0,1,0,0,0,0
"14656","9059572",0,3,0,1,0,1
"14657","9059632",0,4,2,0,0,2
"14658","9059641",0,4,3,0,0,3
"14659","9059644",0,1,0,0,0,0
"14660","9059676",0,3,0,0,0,0
"14661","9059681",0,2,0,0,0,0
"14662","9059706",1,5,8,5,1,14
"14663","9059729",0,3,2,2,0,4
"14664","9059770",0,1,0,0,0,0
"14665","9059798",0,7,1,0,0,1
"14666","9059891",0,4,2,0,0,2
"14667","9059943",0,4,0,0,0,0
"14668","9059954",0,3,1,2,0,3
"14669","9060069",0,2,1,0,0,1
"14670","9060070",0,4,0,1,0,1
"14671","9060073",0,2,0,0,0,0
"14672","9060076",0,3,0,0,0,0
"14673","9060077",0,2,0,0,0,0
"14674","9060245",0,5,2,3,0,5
"14675","9060270",0,3,1,0,0,1
"14676","9060289",0,5,0,0,0,0
"14677","9060293",0,4,1,0,0,1
"14678","9060295",0,4,0,3,0,3
"14679","9060314",0,5,4,1,0,5
"14680","9060543",0,4,5,4,2,11
"14681","9060583",0,2,1,0,0,1
"14682","9060591",0,1,0,0,0,0
"14683","9060817",0,6,5,1,0,6
"14684","9061037",0,4,0,2,0,2
"14685","9061130",0,8,0,3,0,3
"14686","9061172",0,6,1,0,0,1
"14687","9061196",0,7,13,7,1,21
"14688","9061271",0,5,1,2,0,3
"14689","9061328",0,4,0,0,0,0
"14690","9061523",0,1,0,0,0,0
"14691","9061575",0,3,1,0,0,1
"14692","9061673",0,1,0,0,0,0
"14693","9061720",0,6,0,0,0,0
"14694","9061755",0,4,5,0,0,5
"14695","9061791",0,1,1,0,0,1
"14696","9061894",0,4,0,0,0,0
"14697","9061977",0,4,1,2,0,3
"14698","9062170",0,2,4,0,0,4
"14699","9062308",0,5,0,3,1,4
"14700","9062414",0,2,0,0,0,0
"14701","9062588",0,5,2,2,0,4
"14702","9062600",0,5,9,2,0,11
"14703","9062832",1,2,0,0,0,0
"14704","9062864",0,3,1,3,0,4
"14705","9062997",0,1,0,0,0,0
"14706","9063077",0,3,3,0,0,3
"14707","9063088",0,3,0,0,0,0
"14708","9064938",0,4,0,0,0,0
"14709","9065174",0,5,3,0,0,3
"14710","9065349",0,4,1,2,0,3
"14711","9065953",0,4,0,1,0,1
"14712","9066012",0,3,0,1,0,1
"14713","9066015",0,4,2,0,0,2
"14714","9068885",0,4,0,0,0,0
"14715","9069008",0,4,0,0,0,0
"14716","9069029",0,2,0,0,0,0
"14717","9069456",0,3,3,1,0,4
"14718","9069684",0,4,3,3,0,6
"14719","9069842",0,2,0,0,0,0
"14720","9069996",0,3,2,0,0,2
"14721","9070094",0,1,0,1,0,1
"14722","9070096",0,4,2,1,0,3
"14723","9070159",0,3,0,0,0,0
"14724","9071548",0,3,4,1,0,5
"14725","9071568",0,5,2,0,0,2
"14726","9071908",0,5,3,1,1,5
"14727","9072472",0,4,3,0,0,3
"14728","9073354",0,4,2,1,0,3
"14729","9073356",0,9,7,6,0,13
"14730","9073952",0,2,2,0,0,2
"14731","9074726",0,4,5,1,0,6
"14732","9074840",0,1,1,0,0,1
"14733","9074857",0,1,0,0,0,0
"14734","9074920",0,2,0,0,0,0
"14735","9074957",0,2,0,0,0,0
"14736","9075033",0,4,4,2,0,6
"14737","9075272",0,5,2,3,1,6
"14738","9075429",0,3,1,0,0,1
"14739","9075465",0,7,2,2,0,4
"14740","9077805",0,4,0,1,0,1
"14741","9077940",0,1,0,0,0,0
"14742","9077964",0,3,0,0,0,0
"14743","9077984",0,1,0,1,0,1
"14744","9078391",0,6,3,2,1,6
"14745","9078607",0,7,1,4,0,5
"14746","9078676",0,1,1,0,0,1
"14747","9078698",0,1,0,0,0,0
"14748","9079238",0,1,0,0,0,0
"14749","9080308",0,4,6,2,0,8
"14750","9080420",0,4,0,0,0,0
"14751","9080516",0,2,0,0,0,0
"14752","9083533",0,4,2,0,0,2
"14753","9083565",0,6,2,5,0,7
"14754","9083663",1,5,0,3,0,3
"14755","9085210",0,3,0,0,0,0
"14756","9085564",0,4,3,0,0,3
"14757","9086201",0,4,0,0,0,0
"14758","9086321",0,5,1,2,0,3
"14759","9086521",0,2,1,1,0,2
"14760","9086781",0,10,9,7,3,19
"14761","9087934",0,4,6,1,0,7
"14762","9088007",0,1,1,0,0,1
"14763","9088175",0,5,3,0,0,3
"14764","9088199",0,2,0,0,0,0
"14765","9089553",0,9,8,10,4,22
"14766","9089556",0,5,8,10,2,20
"14767","9089700",0,3,0,1,0,1
"14768","9089855",0,4,0,2,0,2
"14769","9089913",0,4,1,1,0,2
"14770","9090166",0,6,13,14,1,28
"14771","9090168",0,5,6,5,1,12
"14772","9090363",0,3,1,1,0,2
"14773","9090634",0,3,1,1,0,2
"14774","9090652",0,4,4,0,0,4
"14775","9091404",0,10,12,7,1,20
"14776","9092492",0,5,9,2,0,11
"14777","9092500",0,1,1,0,0,1
"14778","9092750",0,5,4,0,0,4
"14779","9092765",0,5,5,4,0,9
"14780","9093284",0,8,0,0,0,0
"14781","9093346",0,2,0,0,0,0
"14782","9093500",0,1,0,0,0,0
"14783","9093648",0,2,0,0,0,0
"14784","9093999",0,1,0,0,0,0
"14785","9094021",0,3,1,0,0,1
"14786","9094045",0,5,2,0,0,2
"14787","9094667",0,3,1,1,0,2
"14788","9094673",0,1,0,0,0,0
"14789","9094755",0,6,10,2,0,12
"14790","9094857",0,6,1,1,0,2
"14791","9094864",0,3,1,0,0,1
"14792","9094873",0,6,0,3,1,4
"14793","9095034",0,1,0,1,0,1
"14794","9095112",0,5,2,1,0,3
"14795","9095268",0,5,0,0,0,0
"14796","9095310",0,5,0,0,0,0
"14797","9158853",0,2,2,0,0,2
"14798","9158988",0,3,1,4,0,5
"14799","9159261",0,6,3,4,1,8
"14800","9159329",0,1,0,0,0,0
"14801","9159336",0,5,7,2,0,9
"14802","9224287",0,1,0,0,0,0
"14803","9224290",0,4,2,0,0,2
"14804","9224323",0,2,3,0,0,3
"14805","9224331",0,1,0,0,0,0
"14806","9236619",0,3,2,1,0,3
"14807","9252491",0,3,0,0,0,0
"14808","9281716",0,1,0,0,0,0
"14809","9334446",0,5,8,1,0,9
"14810","9334571",0,1,1,2,0,3
"14811","9334667",0,2,1,0,0,1
"14812","9334853",0,2,2,0,0,2
"14813","9334911",0,1,0,0,0,0
"14814","9335457",0,5,0,0,0,0
"14815","9335461",0,2,1,1,0,2
"14816","9335806",0,5,4,1,0,5
"14817","9335820",0,4,0,4,0,4
"14818","9335895",0,1,1,0,0,1
"14819","9337294",0,1,0,0,0,0
"14820","9337319",0,2,1,1,0,2
"14821","9337458",0,4,0,0,0,0
"14822","9337469",0,4,0,0,0,0
"14823","9337476",0,4,0,0,0,0
"14824","9337616",0,2,0,0,0,0
"14825","9337628",0,7,8,7,1,16
"14826","9337883",1,4,0,0,0,0
"14827","9337934",0,5,4,0,0,4
"14828","9343314",0,4,11,9,2,22
"14829","9343410",0,5,1,0,0,1
"14830","9343431",0,5,5,2,0,7
"14831","9343451",0,4,0,0,0,0
"14832","9343470",0,5,0,0,0,0
"14833","9343783",0,4,0,1,0,1
"14834","9343858",0,5,2,1,0,3
"14835","9343911",0,9,11,11,1,23
"14836","9344058",0,3,0,0,0,0
"14837","9346056",0,2,0,0,0,0
"14838","9346226",0,4,0,1,0,1
"14839","9346249",0,3,0,0,0,0
"14840","9346292",0,4,5,4,0,9
"14841","9346299",0,7,2,0,0,2
"14842","9346577",0,3,0,0,0,0
"14843","9346809",0,3,2,2,0,4
"14844","9346888",0,5,2,3,0,5
"14845","9347038",0,1,0,0,0,0
"14846","9347751",0,6,2,5,3,10
"14847","9347815",0,5,0,0,0,0
"14848","9348188",0,5,0,0,0,0
"14849","9348271",0,1,0,2,0,2
"14850","9348408",0,5,2,3,0,5
"14851","9348474",0,1,0,0,0,0
"14852","9348576",0,1,0,0,0,0
"14853","9348578",0,4,2,4,0,6
"14854","9348808",0,2,0,0,0,0
"14855","9348843",0,3,0,0,0,0
"14856","9348919",0,3,0,1,0,1
"14857","9364488",0,5,2,1,0,3
"14858","9368172",0,7,11,0,1,12
"14859","9368300",0,7,2,1,1,4
"14860","9368307",0,2,0,0,0,0
"14861","9368326",0,2,0,0,0,0
"14862","9368479",0,2,1,0,0,1
"14863","9368497",0,1,0,0,0,0
"14864","9368587",0,2,0,0,0,0
"14865","9368675",0,6,5,2,0,7
"14866","9368695",0,1,0,0,0,0
"14867","9368736",0,4,0,0,0,0
"14868","9377645",0,5,2,0,0,2
"14869","9379216",0,7,6,1,0,7
"14870","9379223",0,4,0,0,0,0
"14871","9379244",0,5,0,0,0,0
"14872","9381228",0,4,3,0,0,3
"14873","9381674",0,3,0,0,0,0
"14874","9381974",0,1,0,0,0,0
"14875","9383077",0,5,3,3,2,8
"14876","9383078",0,3,0,0,0,0
"14877","9383101",0,3,0,0,0,0
"14878","9383145",0,3,0,1,0,1
"14879","9383766",0,6,7,4,0,11
"14880","9384323",0,6,1,8,0,9
"14881","9384324",0,1,0,0,0,0
"14882","9384325",0,7,12,11,1,24
"14883","9384441",0,4,0,1,0,1
"14884","9384449",0,1,0,0,0,0
"14885","9384474",0,1,0,0,0,0
"14886","9384535",0,3,0,0,0,0
"14887","9384551",0,2,3,1,0,4
"14888","9384704",0,1,0,1,0,1
"14889","9384804",0,1,0,0,0,0
"14890","9384815",0,4,0,0,0,0
"14891","9384845",0,4,0,2,0,2
"14892","9384850",0,2,0,1,0,1
"14893","9385064",0,2,0,0,0,0
"14894","9385095",0,2,4,0,0,4
"14895","9385277",0,4,4,0,0,4
"14896","9385278",0,2,2,0,0,2
"14897","9385293",0,3,8,1,0,9
"14898","9385388",0,4,5,0,0,5
"14899","9385393",0,6,1,0,0,1
"14900","9385501",0,6,7,1,0,8
"14901","9385620",0,2,0,0,0,0
"14902","9385642",0,4,2,0,0,2
"14903","9385648",0,4,1,0,0,1
"14904","9385690",0,3,0,0,0,0
"14905","9385713",0,4,2,0,0,2
"14906","9385795",0,4,8,6,0,14
"14907","9385800",0,2,0,0,0,0
"14908","9385836",0,4,0,2,0,2
"14909","9385837",0,8,5,6,0,11
"14910","9385936",0,3,0,1,0,1
"14911","9385984",0,1,0,0,0,0
"14912","9386108",0,2,0,1,0,1
"14913","9386116",0,4,2,0,0,2
"14914","9386138",0,5,3,0,1,4
"14915","9386488",0,4,0,4,0,4
"14916","9386681",0,4,0,0,0,0
"14917","9386757",0,6,9,0,0,9
"14918","9386766",0,5,4,5,0,9
"14919","9386831",0,1,0,0,0,0
"14920","9386834",0,4,1,0,0,1
"14921","9386889",0,4,0,0,0,0
"14922","9386909",0,5,0,0,0,0
"14923","9387308",0,1,0,0,0,0
"14924","9387477",0,2,0,0,0,0
"14925","9387519",0,6,0,2,0,2
"14926","9387552",0,1,0,0,0,0
"14927","9387641",0,4,1,0,0,1
"14928","9387752",0,3,2,3,0,5
"14929","9387948",0,2,0,0,0,0
"14930","9387949",0,2,0,0,0,0
"14931","9388066",0,2,0,0,0,0
"14932","9388068",0,6,6,3,0,9
"14933","9388071",0,3,1,1,0,2
"14934","9388074",0,6,11,13,0,24
"14935","9388148",0,4,0,0,0,0
"14936","9388750",0,2,2,0,0,2
"14937","9388756",0,4,4,1,0,5
"14938","9389787",0,5,4,3,0,7
"14939","9389795",0,3,1,0,0,1
"14940","9390081",0,3,0,0,0,0
"14941","9390095",0,4,2,0,0,2
"14942","9390103",0,5,0,1,0,1
"14943","9390447",0,6,2,5,0,7
"14944","9390466",0,6,3,4,0,7
"14945","9390719",0,2,1,2,0,3
"14946","9390938",0,2,0,0,0,0
"14947","9390948",0,6,10,1,0,11
"14948","9390992",0,2,0,0,0,0
"14949","9391045",0,4,5,0,0,5
"14950","9391113",0,6,0,0,0,0
"14951","9391120",0,4,0,0,0,0
"14952","9391264",0,5,0,0,0,0
"14953","9391375",1,2,0,0,0,0
"14954","9391376",0,4,2,2,0,4
"14955","9391389",0,2,0,0,0,0
"14956","9391509",0,2,0,0,0,0
"14957","9391514",0,4,0,0,0,0
"14958","9391600",0,5,8,0,0,8
"14959","9391671",0,5,3,1,1,5
"14960","9391778",0,1,0,0,0,0
"14961","9392109",0,1,0,0,0,0
"14962","9392117",0,4,9,0,0,9
"14963","9392121",0,4,4,0,0,4
"14964","9392124",0,5,2,0,0,2
"14965","9392136",0,4,2,0,0,2
"14966","9392137",0,4,0,1,0,1
"14967","9392138",0,4,2,1,0,3
"14968","9392238",0,8,9,7,1,17
"14969","9392256",0,3,0,0,0,0
"14970","9392257",0,3,5,1,0,6
"14971","9392260",0,3,0,0,0,0
"14972","9392303",0,3,0,0,0,0
"14973","9392365",0,3,0,0,0,0
"14974","9392370",0,4,1,2,0,3
"14975","9392421",0,4,1,0,0,1
"14976","9392458",0,5,6,3,0,9
"14977","9392512",0,3,1,0,0,1
"14978","9392559",0,4,0,0,0,0
"14979","9392603",0,4,3,2,0,5
"14980","9392620",0,5,1,4,1,6
"14981","9392762",0,4,4,0,0,4
"14982","9392867",0,2,0,0,0,0
"14983","9392963",0,4,6,1,0,7
"14984","9393062",0,2,0,0,0,0
"14985","9393072",0,4,2,1,0,3
"14986","9393083",0,1,0,0,0,0
"14987","9393115",0,4,0,0,0,0
"14988","9393127",0,7,9,4,0,13
"14989","9393178",0,6,3,1,0,4
"14990","9393219",0,1,0,0,0,0
"14991","9393282",0,6,12,4,1,17
"14992","9393290",0,6,3,2,0,5
"14993","9393372",0,2,0,0,0,0
"14994","9393405",0,6,0,2,0,2
"14995","9393543",0,4,0,0,0,0
"14996","9393597",0,5,2,0,0,2
"14997","9393638",0,2,2,0,0,2
"14998","9393723",0,4,0,0,0,0
"14999","9393750",0,7,13,2,0,15
"15000","9393796",0,4,2,0,0,2
"15001","9393880",0,3,1,0,0,1
"15002","9393935",0,4,0,2,0,2
"15003","9394116",0,8,5,1,0,6
"15004","9394222",0,1,0,0,0,0
"15005","9394225",0,5,2,0,0,2
"15006","9394314",0,4,1,0,0,1
"15007","9394315",0,5,6,0,0,6
"15008","9394433",0,8,1,3,0,4
"15009","9394592",0,3,1,1,0,2
"15010","9394641",0,5,4,1,0,5
"15011","9394673",0,1,0,0,1,1
"15012","9394683",0,4,0,0,0,0
"15013","9394803",0,6,6,5,0,11
"15014","9394921",0,3,0,0,0,0
"15015","9395149",0,3,4,4,0,8
"15016","9395167",0,2,0,0,0,0
"15017","9395212",0,4,1,0,0,1
"15018","9395377",0,7,7,5,2,14
"15019","9395380",0,5,5,7,0,12
"15020","9395386",0,1,0,0,0,0
"15021","9395542",0,4,0,1,0,1
"15022","9395734",0,1,0,0,0,0
"15023","9395910",0,4,0,0,0,0
"15024","9396252",0,3,3,1,0,4
"15025","9396260",0,5,1,0,0,1
"15026","9396472",0,4,5,1,0,6
"15027","9396492",0,6,7,5,1,13
"15028","9396678",0,4,0,0,0,0
"15029","9396806",0,4,0,0,0,0
"15030","9396958",0,6,5,3,0,8
"15031","9397015",0,1,2,2,0,4
"15032","9397237",0,4,0,0,0,0
"15033","9397295",0,4,1,1,0,2
"15034","9397377",1,3,0,0,0,0
"15035","9397378",0,4,0,1,0,1
"15036","9397512",0,3,3,1,0,4
"15037","9397602",0,4,0,0,0,0
"15038","9397606",0,5,7,0,0,7
"15039","9397750",0,2,3,0,0,3
"15040","9397780",0,2,1,1,0,2
"15041","9397872",0,6,8,2,0,10
"15042","9397883",0,3,5,5,0,10
"15043","9397952",0,1,0,0,0,0
"15044","9397959",0,4,0,0,0,0
"15045","9397973",0,7,9,11,0,20
"15046","9398089",0,7,3,8,1,12
"15047","9398109",0,4,4,5,0,9
"15048","9398154",0,1,0,0,0,0
"15049","9398183",0,5,3,1,0,4
"15050","9398210",0,4,0,0,0,0
"15051","9398390",0,2,1,1,0,2
"15052","9398491",0,3,0,1,0,1
"15053","9398528",0,4,9,0,0,9
"15054","9398714",1,4,1,1,0,2
"15055","9398808",0,6,7,4,2,13
"15056","9398860",0,1,1,0,0,1
"15057","9398888",0,7,1,3,0,4
"15058","9399001",0,3,1,0,0,1
"15059","9399015",0,2,0,1,0,1
"15060","9399101",0,4,0,1,0,1
"15061","9399445",0,7,9,3,1,13
"15062","9399714",0,1,1,0,0,1
"15063","9399857",0,1,0,0,0,0
"15064","9399911",0,5,3,4,0,7
"15065","9399949",0,4,6,4,0,10
"15066","9400088",0,7,8,0,0,8
"15067","9400196",0,4,4,0,0,4
"15068","9400227",0,1,0,0,0,0
"15069","9400351",1,4,0,0,0,0
"15070","9400901",0,4,0,1,0,1
"15071","9401090",0,3,0,4,0,4
"15072","9401265",0,5,5,4,0,9
"15073","9401546",0,6,2,2,0,4
"15074","9401739",0,3,0,1,0,1
"15075","9401756",0,1,0,0,0,0
"15076","9401876",0,5,0,0,0,0
"15077","9401877",0,3,2,1,0,3
"15078","9401883",0,2,0,0,0,0
"15079","9401965",0,3,4,5,0,9
"15080","9402157",0,4,2,0,0,2
"15081","9402158",0,7,5,6,1,12
"15082","9402766",0,7,7,2,0,9
"15083","9402792",0,3,0,1,0,1
"15084","9402904",0,4,3,0,0,3
"15085","9403060",0,2,0,0,0,0
"15086","9403089",0,3,6,1,0,7
"15087","9403181",0,4,2,1,0,3
"15088","9403280",0,6,0,0,0,0
"15089","9403297",0,6,15,5,0,20
"15090","9403423",0,7,4,5,0,9
"15091","9403620",0,1,0,0,0,0
"15092","9403661",0,4,3,0,0,3
"15093","9403674",0,4,1,0,0,1
"15094","9403790",0,1,0,1,0,1
"15095","9403875",0,1,1,0,0,1
"15096","9403994",0,4,1,0,0,1
"15097","9404076",0,1,1,0,0,1
"15098","9404101",0,5,3,2,0,5
"15099","9404200",1,4,0,0,0,0
"15100","9404206",0,6,3,1,0,4
"15101","9404232",0,4,5,2,1,8
"15102","9404519",0,6,2,1,0,3
"15103","9404595",0,1,2,0,0,2
"15104","9404605",0,4,0,0,0,0
"15105","9404676",0,4,1,0,0,1
"15106","9404681",0,1,0,0,0,0
"15107","9404885",0,2,0,0,0,0
"15108","9405052",0,8,5,14,1,20
"15109","9405149",0,3,5,4,0,9
"15110","9405182",0,1,0,0,0,0
"15111","9405215",0,1,0,0,0,0
"15112","9405350",0,2,0,0,0,0
"15113","9405522",0,4,4,1,0,5
"15114","9405770",0,1,0,0,0,0
"15115","9405823",0,3,2,0,0,2
"15116","9405831",0,3,2,2,0,4
"15117","9405952",0,5,1,0,1,2
"15118","9405969",0,5,3,0,0,3
"15119","9406082",0,2,1,0,0,1
"15120","9406124",0,4,5,0,0,5
"15121","9406355",0,6,1,1,0,2
"15122","9406360",0,4,10,4,0,14
"15123","9406365",0,7,8,4,1,13
"15124","9406551",0,4,0,0,0,0
"15125","9406585",0,5,1,2,0,3
"15126","9406669",0,3,0,2,0,2
"15127","9406837",0,4,4,0,0,4
"15128","9406854",0,2,0,0,0,0
"15129","9406883",0,4,2,6,0,8
"15130","9406893",0,4,0,0,0,0
"15131","9407044",0,4,5,1,0,6
"15132","9407262",0,6,6,4,1,11
"15133","9407267",0,6,6,5,0,11
"15134","9407401",0,4,0,0,0,0
"15135","9407429",0,4,4,1,0,5
"15136","9407738",0,8,8,8,1,17
"15137","9407754",0,6,4,0,0,4
"15138","9407790",0,5,0,0,0,0
"15139","9408152",0,6,4,2,0,6
"15140","9408154",0,4,5,4,0,9
"15141","9408355",0,1,1,0,0,1
"15142","9408426",0,6,4,1,0,5
"15143","9408572",0,3,4,3,0,7
"15144","9408665",0,1,0,0,0,0
"15145","9408703",0,3,2,0,0,2
"15146","9408792",0,2,1,0,0,1
"15147","9408900",0,1,0,0,0,0
"15148","9409099",0,4,3,1,0,4
"15149","9409151",0,6,3,3,0,6
"15150","9409392",0,6,9,2,2,13
"15151","9409624",0,1,0,0,0,0
"15152","9409868",0,4,5,0,0,5
"15153","9409939",0,4,0,0,0,0
"15154","9409998",0,2,1,0,0,1
"15155","9410020",0,3,0,0,0,0
"15156","9410128",0,2,0,0,0,0
"15157","9410144",0,4,0,1,0,1
"15158","9410252",0,7,15,7,1,23
"15159","9410320",0,4,2,3,0,5
"15160","9410383",0,1,0,0,0,0
"15161","9410702",0,3,0,0,0,0
"15162","9410768",0,2,0,0,0,0
"15163","9410823",0,4,4,2,0,6
"15164","9410863",0,1,0,0,0,0
"15165","9410916",0,4,2,1,0,3
"15166","9411146",0,3,1,2,0,3
"15167","9411208",0,4,5,0,0,5
"15168","9411343",0,3,0,1,0,1
"15169","9411345",0,2,0,1,0,1
"15170","9411835",0,2,0,0,0,0
"15171","9412118",0,4,2,0,0,2
"15172","9412230",0,6,6,0,0,6
"15173","9412631",0,4,0,0,0,0
"15174","9412706",0,4,0,1,0,1
"15175","9412729",0,2,0,0,0,0
"15176","9412738",0,4,0,1,0,1
"15177","9412792",0,3,0,0,0,0
"15178","9413070",0,2,2,0,0,2
"15179","9413162",0,4,0,0,0,0
"15180","9413205",0,6,4,1,0,5
"15181","9413209",0,6,0,2,0,2
"15182","9413217",0,5,9,0,0,9
"15183","9413238",0,4,1,11,0,12
"15184","9413246",0,6,7,4,0,11
"15185","9413306",0,6,6,3,0,9
"15186","9413610",0,7,0,0,0,0
"15187","9413639",0,1,0,0,0,0
"15188","9413664",0,4,1,0,0,1
"15189","9414011",0,6,4,1,0,5
"15190","9414045",0,5,2,2,0,4
"15191","9414208",0,3,2,0,0,2
"15192","9414366",0,4,0,0,0,0
"15193","9414370",0,3,2,0,0,2
"15194","9414402",0,2,0,2,0,2
"15195","9414413",0,3,0,0,0,0
"15196","9414589",0,2,2,0,0,2
"15197","9414754",0,4,0,2,0,2
"15198","9414978",0,4,2,2,0,4
"15199","9414986",0,1,0,0,0,0
"15200","9415256",0,2,3,0,0,3
"15201","9415277",0,4,0,2,1,3
"15202","9415495",0,7,9,3,0,12
"15203","9415551",0,6,1,2,0,3
"15204","9415782",0,3,6,4,0,10
"15205","9415829",0,1,0,0,0,0
"15206","9415840",0,4,0,0,0,0
"15207","9415894",0,4,7,4,2,13
"15208","9415928",0,3,2,0,0,2
"15209","9416045",0,1,0,0,0,0
"15210","9416066",0,4,1,1,0,2
"15211","9416087",0,3,3,0,0,3
"15212","9416431",0,4,3,0,0,3
"15213","9416544",0,2,0,0,0,0
"15214","9416594",0,2,1,0,0,1
"15215","9416626",0,8,11,6,1,18
"15216","9416632",0,4,0,0,0,0
"15217","9416678",0,2,1,1,0,2
"15218","9416699",0,5,6,0,0,6
"15219","9416904",0,1,0,0,0,0
"15220","9416936",0,1,0,0,0,0
"15221","9416959",0,6,4,0,0,4
"15222","9417216",0,5,4,1,0,5
"15223","9417218",0,5,1,0,0,1
"15224","9417234",0,4,0,0,0,0
"15225","9417337",0,5,8,2,0,10
"15226","9417389",0,2,0,0,0,0
"15227","9417542",0,3,2,0,0,2
"15228","9417710",0,1,1,0,0,1
"15229","9417737",0,1,2,0,0,2
"15230","9417941",0,7,3,8,0,11
"15231","9418108",0,7,12,4,2,18
"15232","9418137",0,4,8,0,0,8
"15233","9418235",0,1,0,0,0,0
"15234","9418268",0,3,0,0,0,0
"15235","9418275",0,4,6,0,0,6
"15236","9418424",0,1,0,0,0,0
"15237","9418647",0,3,0,0,0,0
"15238","9418663",0,1,0,0,0,0
"15239","9418665",0,1,0,0,0,0
"15240","9418726",0,2,2,0,0,2
"15241","9418729",0,6,2,1,1,4
"15242","9418778",0,1,0,0,0,0
"15243","9418809",0,5,0,4,1,5
"15244","9418820",0,5,1,0,0,1
"15245","9418835",0,6,3,1,0,4
"15246","9418892",0,10,16,3,0,19
"15247","9418978",0,6,6,2,1,9
"15248","9419024",0,4,4,1,1,6
"15249","9419036",0,4,1,0,0,1
"15250","9419188",0,1,0,0,0,0
"15251","9419265",0,3,0,0,0,0
"15252","9419333",0,6,2,0,0,2
"15253","9419357",0,4,4,4,0,8
"15254","9419383",0,1,0,0,0,0
"15255","9419384",0,2,0,0,0,0
"15256","9419385",0,1,0,0,0,0
"15257","9419389",0,3,0,0,0,0
"15258","9419393",0,8,6,1,1,8
"15259","9419444",0,1,1,0,0,1
"15260","9419446",0,5,0,5,0,5
"15261","9419480",0,7,15,14,4,33
"15262","9419563",0,4,3,0,0,3
"15263","9419578",0,4,1,1,0,2
"15264","9419687",0,6,9,1,0,10
"15265","9419702",0,3,1,2,0,3
"15266","9419710",0,5,14,4,0,18
"15267","9419741",0,1,0,0,0,0
"15268","9419810",1,4,0,1,0,1
"15269","9419817",0,2,0,0,0,0
"15270","9419950",0,4,0,1,0,1
"15271","9419978",0,1,0,0,0,0
"15272","9419994",0,2,1,0,0,1
"15273","9420123",0,3,0,2,0,2
"15274","9420191",0,4,1,0,0,1
"15275","9420234",0,3,0,0,0,0
"15276","9420238",0,2,0,0,0,0
"15277","9420245",0,4,0,0,0,0
"15278","9420270",0,2,1,0,0,1
"15279","9420358",0,1,0,0,0,0
"15280","9420359",1,4,1,0,0,1
"15281","9420380",0,1,0,0,0,0
"15282","9420432",0,3,1,0,0,1
"15283","9420561",0,4,0,0,0,0
"15284","9420567",0,3,0,0,0,0
"15285","9420608",0,2,0,1,0,1
"15286","9420614",0,4,0,0,0,0
"15287","9420635",0,6,12,2,0,14
"15288","9420757",0,2,3,0,0,3
"15289","9420774",0,2,0,0,0,0
"15290","9420777",0,1,0,0,0,0
"15291","9420794",0,1,0,0,0,0
"15292","9420914",0,5,4,1,0,5
"15293","9420923",0,3,0,2,0,2
"15294","9420965",0,3,0,0,0,0
"15295","9421064",0,1,0,0,0,0
"15296","9421133",0,6,2,3,0,5
"15297","9421212",0,2,0,0,0,0
"15298","9421367",0,3,1,1,0,2
"15299","9421400",0,4,0,2,0,2
"15300","9421462",0,2,0,0,0,0
"15301","9421481",0,3,8,1,0,9
"15302","9421520",0,5,2,0,0,2
"15303","9421632",0,4,5,0,1,6
"15304","9421633",0,2,1,0,0,1
"15305","9421791",0,2,2,0,0,2
"15306","9421826",0,4,4,0,0,4
"15307","9421850",0,1,0,0,0,0
"15308","9421922",1,8,9,5,2,16
"15309","9421924",0,1,0,0,0,0
"15310","9421960",0,3,4,0,0,4
"15311","9422066",1,2,0,0,0,0
"15312","9422076",0,2,0,0,0,0
"15313","9422101",0,1,0,0,0,0
"15314","9422163",0,2,0,0,0,0
"15315","9422557",0,6,9,4,0,13
"15316","9422639",0,1,0,0,0,0
"15317","9422667",0,5,2,1,0,3
"15318","9422831",0,4,2,0,0,2
"15319","9422907",0,1,0,0,0,0
"15320","9422989",0,5,0,0,0,0
"15321","9423057",0,2,0,1,0,1
"15322","9423075",0,6,8,4,0,12
"15323","9423119",0,1,0,0,0,0
"15324","9423131",0,2,0,1,0,1
"15325","9423241",0,3,0,1,0,1
"15326","9423396",0,4,4,1,0,5
"15327","9423435",0,2,0,0,0,0
"15328","9423589",0,4,5,5,1,11
"15329","9423697",0,4,5,4,1,10
"15330","9423779",0,2,1,0,0,1
"15331","9423857",0,1,0,0,0,0
"15332","9423917",0,4,0,0,0,0
"15333","9423954",0,3,0,6,1,7
"15334","9423963",0,4,0,0,0,0
"15335","9424121",0,1,1,0,0,1
"15336","9424177",0,4,5,0,0,5
"15337","9424188",0,1,1,0,0,1
"15338","9424189",0,4,0,0,0,0
"15339","9424319",0,3,3,0,0,3
"15340","9424377",0,4,4,1,0,5
"15341","9424427",0,7,5,4,1,10
"15342","9424513",0,4,0,0,0,0
"15343","9424661",0,3,0,0,0,0
"15344","9424683",0,4,0,0,0,0
"15345","9424692",0,1,0,0,0,0
"15346","9424708",0,3,1,0,0,1
"15347","9424718",0,2,3,1,0,4
